A protein can be seen as a corporate hub in that it is the central molecule around which many other molecules orbit. Proteins are responsible for organizing and directing the activities of these other molecules, much like how a corporate hub oversees the activities of its employees.	proteins	How is proteins analogous to corporate hub?
A protein is analogous to a citizen in that they are both essential in order for the organism to function. Proteins are responsible for performing many biochemical tasks, including building and repairing tissues, transporting molecules throughout the body, and catalyzing chemical reactions. In addition, proteins play a role in regulating cellular processes. Just as citizens are vital members of society who make important contributions, proteins are essential components of cells that perform critical functions.	proteins	How is proteins analogous to citizens?
Just as a hub is the central part of a wheel, proteins are the central part of cells. Proteins play many important roles in cells, including providing structure, controlling cell activities, and transporting molecules into and out of cells.	proteins	How is proteins analogous to corporate hub?
A protein is analogous to a citizen in that they are both essential for life. Proteins play a role in all cellular processes, and are necessary for the body to create new cells, tissues, and organs. Similarly, citizens are essential for a functioning society; they provide labor and contribute to the economy, while also participating in government and civil society.	proteins	How is proteins analogous to citizens?
Proteins are analogous to corporate hubs because they are both essential for the functioning of their respective systems. Proteins carry out a variety of biochemical tasks within cells, including catalyzing chemical reactions and assembling other molecules. Likewise, corporate hubs provide critical functions within economies, such as connecting businesses and consumers and facilitating trade. Additionally, both proteins and corporate hubs can be said to have a certain level of monopolistic power; that is, they are not easily replaced by other entities within their respective domains.	proteins	How is proteins analogous to corporate hub?
DNA is similar to city files in that they are both organized in a specific way. The DNA molecule is made up of four nitrogen bases: Adenine (A), thymine (T), cytosine (C), and guanine (G). These letters form "words" called codons, which are the building blocks of proteins. Just as cities have streets and avenues, DNA has "channels" called genes that dictate how a particular protein is formed.	dna	How is dna analogous to city files?
Just as a computer's hard disk stores data, DNA can be thought of as the hard disk of a cell. The information in DNA is used to create proteins, which carry out most of the work in cells.	dna	How is dna analogous to hard disk of a computer?
A manufacturing instruction is a set of written or printed instructions specifying the order in which work must be done to produce a particular object. DNA can be thought of as a set of written or printed instructions that specify the order in which work must be done to produce an organism.	dna	How is dna analogous to manufacturing instructions?
Each nucleotide in a strand of DNA is like a file folder, and the genetic information it contains is analogous to the information contained in each city's files. Just as folders can be arranged in any order, so too can the sequence of nucleotides within a strand of DNA be manipulated to create new proteins. And just as different cities can have different types of information stored in their files, so too do different genes produce unique proteins.	dna	How is dna analogous to city files?
Dna is analogous to a hard disk of a computer because they are both storage devices.	dna	How is dna analogous to hard disk of a computer?
Glycogen is a storage molecule for glucose, which is analogous to the way rechargeable batteries store energy.	glycogen	How is glycogen analogous to rechargeable batteries?
Glycogen is a carbohydrate that is stored in the liver and muscles. It can be converted into glucose, which is used for energy by the body. Rechargeable batteries store electricity, which can be used to power devices.	glycogen	How is glycogen analogous to rechargeable batteries?
Glycogen is analogous to supermarkets because glycogen stores are like a supermarket for the body. The body can store a lot of glucose in the form of glycogen, and then use that glycogen as necessary. Just like you might go to the supermarket when you need food, the body can go to its glycogen stores when it needs energy.	glycogen	How is glycogen analogous to supermarkets?
Glycogen is an energy store in the body that is analogous to supermarkets. Just as glycogen stores are depleted during physical activity, supermarkets are emptied of food when shoppers take items from the shelves. And just as glycogen can be replenished through rest and nutrition, supermarkets can restock their shelves with new food after a period of time.	glycogen	How is glycogen analogous to supermarkets?
Glycogen is analogous to rechargeable batteries because they are both used to store energy. Glycogen is stored in the liver and muscles and is used to fuel activities such as running or swimming. Rechargeable batteries are used to power electronic devices and can be recharged by plugging them into an outlet.	glycogen	How is glycogen analogous to rechargeable batteries?
Nadh is analogous to courier service in that it transports energy throughout the body.	nadh	How is nadh analogous to courier service?
Nadh is necessary for daily life in the same way that oxygen is. Both are essential to survival.	nadh	How is nadh analogous to things that are necessary in daily life?
Nadh is analogous to courier service because it delivers energy to the cells in the body.	nadh	How is nadh analogous to courier service?
Nadh is analogous to courier service because it delivers energy throughout the body. Just as a courier service delivers packages from one location to another, nadh delivers energy from the cytoplasm of one cell to another.	nadh	How is nadh analogous to courier service?
Nadh is analogous to things that are necessary in daily life because it is a molecule that is necessary for the body to function properly. It helps to convert food into energy, and without it, the body would not be able to do many of the things that are necessary for daily life.	nadh	How is nadh analogous to things that are necessary in daily life?
One way that the endoplasmic reticulum can be analogous to a classroom is by looking at it as a space for learning. Just like in a classroom, new information is processed and taught in the endoplasmic reticulum. Additionally, just as students learn best when they are engaged and interactive, proteins within the endoplasmic reticulum also learn best when they are active and interacting with other molecules.	endoplasmic reticulum	How is endoplasmic reticulum analogous to classroom?
Endoplasmic reticulum is analogous to industry because it processes and manufactures proteins.	endoplasmic reticulum	How is endoplasmic reticulum analogous to industry?
Endoplasmic reticulum is analogous to offices of chiefs of different departments because it is responsible for the production and secretion of proteins.	endoplasmic reticulum	How is endoplasmic reticulum analogous to offices of chiefs of different departments?
The analogy between the endoplasmic reticulum and a restaurant kitchen is that they are both places where food is processed. In the kitchen, food is chopped, cooked, and prepared for serving. In the endoplasmic reticulum, proteins are translated from RNA and folded into their correct shapes.	endoplasmic reticulum	How is endoplasmic reticulum analogous to restaurant kitchen?
One way to think of the endoplasmic reticulum (ER) is as a large classroom. The ER has many different "desks" for different types of proteins and enzymes to do their work. Just like in a classroom, each desk has its own space and tools to help the student do their work.	endoplasmic reticulum	How is endoplasmic reticulum analogous to classroom?
Golgi is analogous to offices where people are working in the building of the municipal government because they are both places where things are processed. In the office, people work on paperwork and process it. Similarly, golgi processes proteins and sends them off to their correct destinations.	golgi	How is golgi analogous to offices where people are working in the building of the municipal government?
Golgi is analogous to offices where people are working in the building of the municipal government in that they are both places where things happen. In golgi, proteins and other molecules are created and processed, while in the municipal government, laws are made and enforced.	golgi	How is golgi analogous to offices where people are working in the building of the municipal government?
Golgi is analogous to offices where people are working in the building of the municipal government because both Golgi and the offices are places where things happen. In Golgi, proteins and other materials are created and sent out to different parts of the cell, while in the municipal government, people work together to make decisions that affect everyone in the city.	golgi	How is golgi analogous to offices where people are working in the building of the municipal government?
Golgi is analogous to offices where people are working in the building of the municipal government because it is a system that helps to process and distribute information.	golgi	How is golgi analogous to offices where people are working in the building of the municipal government?
Golgi is analogous to offices where people are working in the building of the municipal government because they both provide a space for work and organization.	golgi	How is golgi analogous to offices where people are working in the building of the municipal government?
A city's edge is analogous to a plasma membrane in that they are both physical boundaries that separate two different entities. A city's edge is the boundary between the city and the surrounding rural area, while a plasma membrane is the boundary between the cell and its environment.	plasma membrane	How is plasma membrane analogous to edge of the city?
The analogy between the plasma membrane and the edge of a city is that they are both boundaries. The plasma membrane separates the interior of a cell from its environment, while the edge of a city separates the city from its surroundings.	plasma membrane	How is plasma membrane analogous to edge of the city?
The plasma membrane is analogous to the edge of the city because it separates the inside of the cell from its surroundings and controls what enters and leaves.	plasma membrane	How is plasma membrane analogous to edge of the city?
The plasma membrane is analogous to the edge of the city in that they are both boundaries. The plasma membrane separates the interior of the cell from its environment, while the edge of the city marks the limit of a city's jurisdiction.	plasma membrane	How is plasma membrane analogous to edge of the city?
A city's edge is analogous to a plasma membrane because they are both boundaries. The plasma membrane separates the interior of a cell from its environment, while the city's edge separates the city from its surroundings.	plasma membrane	How is plasma membrane analogous to edge of the city?
The analogy between the lysosome and stomach is that they are both digestive organs. The lysosome breaks down macromolecules into smaller molecules, while the stomach breaks down food into small pieces so that it can be absorbed by the body.	lysosome	How is lysosome analogous to stomach?
The analogy between lysosomes and garbage disposals is that they are both responsible for breaking down waste products. Lysosomes break down cellular debris, while garbage disposals break down food scraps.	lysosome	How is lysosome analogous to garbage disposal?
Lysosomes are analogous to a police station in that they are both responsible for maintaining law and order within their respective domains. Lysosomes patrol the cell, seeking out damaged or defective organelles and proteins for disposal, while police officers maintain order in the community by enforcing laws and investigating crimes.	lysosome	How is lysosome analogous to police station?
The stomach is analogous to the lysosome because they are both organs that break down food.	lysosome	How is lysosome analogous to stomach?
A lysosome is a small organelle in the cell that breaks down substances. It can be thought of as analogous to a hospital, which breaks down and recycles materials.	lysosome	How is lysosome analogous to hospital?
Peroxisomes are analogous to a garbage delivery system in that they both transport and degrade materials. Peroxisomes transfer proteins and lipids from the cytoplasm to the organelles, where they are degraded. This is similar to how a garbage truck delivers trash to a landfill, where it is broken down into smaller pieces.	peroxisomes	How is peroxisomes analogous to garbage delivery system?
Garbage collectors collect garbage and take it to a landfill or recycling center. Peroxisomes remove waste products from the cytoplasm of cells and take them to the lysosome for disposal.	peroxisomes	How is peroxisomes analogous to garbage delivery system?
Garbage collectors go through city streets collecting trash and taking it to a landfill or recycling center. Peroxisomes are analogous to the garbage collectors because they collect waste products (such as free radicals) from the cytoplasm and take them to the lysosome for destruction.	peroxisomes	How is peroxisomes analogous to garbage delivery system?
Peroxisomes are analogous to garbage delivery systems because they both break down large molecules into smaller ones.	peroxisomes	How is peroxisomes analogous to garbage delivery system?
Peroxisomes are analogous to garbage delivery systems in that they both remove wastes from the cells. Peroxisomes break down fatty acids and amino acids, and remove the resulting waste products from the cell. Garbage delivery systems collect municipal trash and deliver it to a landfill or recycling center.	peroxisomes	How is peroxisomes analogous to garbage delivery system?
A mitochondrion is analogous to a power plant in that they are both responsible for producing energy. In a power plant, this energy is used to generate electricity. In a mitochondrion, this energy is used to produce ATP (adenosine triphosphate), which is the cell's main source of energy.	mitochondria	How is mitochondria analogous to power plant?
The mitochondria are analogous to the electric station in that they both produce energy for the cell. The mitochondria produce adenosine triphosphate (ATP) which is used by the cells to carry out its functions. The electric station produces electricity which is used to power homes and businesses.	mitochondria	How is mitochondria analogous to electric station?
Burger drawers are typically located in the refrigerator below the main body of the refrigerator. They are drawers that pull out and have a lot of space inside to store hamburgers, hot dogs, and other meats. Similarly, mitochondria are organelles found in cells. They are responsible for producing energy for the cell through respiration. They also have a lot of space inside them to store enzymes and other chemicals necessary for cellular respiration.	mitochondria	How is mitochondria analogous to burger drawers?
Both mitochondria and restaurants are necessary for the survival of cells and humans, respectively. Mitochondria produce energy for cells while restaurants provide food for humans. Furthermore, both mitochondria and restaurants can be damaged or destroyed, leading to impairment or death.	mitochondria	How is mitochondria analogous to restaurants?
A power plant analogy for mitochondria would be that the mitochondria are the powerhouse of the cell, producing energy in the form of adenosine triphosphate (ATP). Just as a power plant needs fuel to produce electricity, mitochondria need food to produce ATP. The food that is most commonly used by mitochondria is glucose.	mitochondria	How is mitochondria analogous to power plant?
A chloroplast is an organelle in a plant cell that is analogous to a food production factory because it produces energy in the form of sugar from light and carbon dioxide.	chloroplast	How is chloroplast analogous to food production factory?
Chloroplasts are analogous to solar energy plants because they convert sunlight into chemical energy that can be used by plants to create glucose from carbon dioxide and water.	chloroplast	How is chloroplast analogous to solar energy plants?
Chloroplasts are analogous to kitchens because they both have the ability to create something edible. In a kitchen, you can cook food and make it into a meal. Similarly, in a chloroplast, you can take light and use it to create glucose from carbon dioxide and water.	chloroplast	How is chloroplast analogous to kitchen?
The chloroplast is analogous to the kitchen because they are both places where something is made. The chloroplast is where photosynthesis occurs and the kitchen is where food is made.	chloroplast	How is chloroplast analogous to kitchen?
A chloroplast is analogous to a food production factory in that it is responsible for the synthesis of carbohydrates in plants.	chloroplast	How is chloroplast analogous to food production factory?
The cytoskeleton is analogous to a metal framework in that they are both used to provide structural support.	cytoskeleton	How is cytoskeleton analogous to metal framework?
The cytoskeleton is analogous to a metal framework in that it provides support and structure for the cell.	cytoskeleton	How is cytoskeleton analogous to metal framework?
The cytoskeleton is analogous to a metal framework in that they are both composed of repeating structural units. The metal framework can be used to support heavy loads, while the cytoskeleton provides strength and rigidity to cells.	cytoskeleton	How is cytoskeleton analogous to metal framework?
The cytoskeleton is analogous to a metal framework in that they are both structural components of the cell. The cytoskeleton provides support and structure to the cell, while the metal framework provides support and structure to a building.	cytoskeleton	How is cytoskeleton analogous to metal framework?
The cytoskeleton can be analogy to a street because it is a three-dimensional network of protein filaments that provides support and shape to the cell, just as a street does for a city. The cytoskeleton also helps cells move around, just as streets help cars and people get around cities.	cytoskeleton	How is cytoskeleton analogous to street?
 ATP is analogous to ready-to-eat food because it is an energy source that can be used by the body to fuel its activities.	atp	How is atp analogous to ready to eat food?
Atp is analogous to a charged battery because they are both used to store and release energy.	atp	How is atp analogous to charged battery?
ATP is analogous to a charged battery in that it can release energy when it reacts with another molecule.	atp	How is atp analogous to charged battery?
Atp is analogous to a charged battery because it provides the energy that cells need to function.	atp	How is atp analogous to charged battery?
Atp is analogous to money because it is a form of currency that can be used to purchase goods and services.	atp	How is atp analogous to money?
NADPH is similar to bus in that they are both essential for the functioning of their respective systems. NADPH is necessary for photosynthesis, while bus is necessary for public transportation.	nadph	How is nadph analogous to bus?
NADPH is analogous to bus because they are both necessary for the function of their respective cells. NADPH is necessary for photosynthesis, and bus service is necessary for public transportation.	nadph	How is nadph analogous to bus?
NADPH is analogous to bus because they are both necessary for the functioning of their respective systems. Bus is necessary for the transportation of people and goods, while NADPH is necessary for photosynthesis.	nadph	How is nadph analogous to bus?
NADPH is analogous to bus because they are both necessary for the process of photosynthesis. NADPH is a cofactor that helps transfer electrons in the light-dependent reactions, while bus transports passengers between two points.	nadph	How is nadph analogous to bus?
NADPH is similar to bus in that they are both necessary for the cell to function. NADPH is necessary for the production of energy in the cells, while bus is necessary for the transportation of passengers.	nadph	How is nadph analogous to bus?
Peroxysomes are analogous to street cleaners because they both clean up the mess. In the case of peroxysomes, this means getting rid of harmful toxins and byproducts from the cell.	peroxysome	How is peroxysome analogous to street cleaners?
Peroxysomes are analogous to street cleaners because they clean up the cellular debris.	peroxysome	How is peroxysome analogous to street cleaners?
Peroxysomes are analogous to street cleaners because they clean up debris and toxins in the cell.	peroxysome	How is peroxysome analogous to street cleaners?
Street cleaners are analogous to peroxysomes because they both clean up messes. Peroxysomes clean up the free radicals that are created when oxygen is used by cells. Street cleaners clean up the trash on the street.	peroxysome	How is peroxysome analogous to street cleaners?
Peroxysomes are analogous to street cleaners because they clean up the cell by removing waste products.	peroxysome	How is peroxysome analogous to street cleaners?
Mytochondria is analogous to power point in that they are both organelles within the cell. Mytochondria produces energy for the cell, while power point provides electricity for presentations and other electronic devices.	mytochondria	How is mytochondria analogous to power point?
Your mitochondria are analogous to power point because they both produce energy for the cells in your body.	mytochondria	How is mytochondria analogous to power point?
A mitochondria is a power point for the cell. It is responsible for creating energy in the form of adenosine triphosphate (ATP) from food molecules.	mytochondria	How is mytochondria analogous to power point?
Your mitochondria are analogous to power point in that they are both responsible for generating energy in your body.	mytochondria	How is mytochondria analogous to power point?
Myochondria are organelles found in cells that produce energy for the cell. Powerpoint is a program used to create presentations with text, images, and videos.	mytochondria	How is mytochondria analogous to power point?
Electric forces between two electric charges are similar to the force that is created when you comb your hair. The force between the positive and negative charges in each molecule of your hair creates a "bundle" of hairs. When you brush your hair, you move all of these bundles in the same direction, creating a large force on the surface of your head. Electric forces work in a very similar way. Positive and negative charges create "fields" around them that push other charged objects away.	electric forces	How is electric forces analogous to comb and pieces of paper?
Electric forces are analogous to comb and pieces of paper because they are both examples of electrostatic force.	electric forces	How is electric forces analogous to comb and pieces of paper?
Electric forces are similar to comb and pieces of paper because they are both attractive or repulsive forces.	electric forces	How is electric forces analogous to comb and pieces of paper?
Electric forces between two objects are similar to the force of attraction between two pieces of paper or the force of attraction between a comb and a piece of hair.	electric forces	How is electric forces analogous to comb and pieces of paper?
Electric forces are analogous to comb and pieces of paper because they are both examples of static electricity.	electric forces	How is electric forces analogous to comb and pieces of paper?
A hydrogen electron's orbital is analogous to Earth's atmosphere because they are both two-dimensional.	hydrogen electron's orbital	How is hydrogen electron's orbital analogous to earth’s atmosphere?
The orbital of a hydrogen electron is analogous to earth's atmosphere in that they are both two-dimensional.	hydrogen electron's orbital	How is hydrogen electron's orbital analogous to earth’s atmosphere?
Just as the electron's orbital surrounds the nucleus of an atom, Earth's atmosphere wraps around our planet. The electron's orbital can be thought of as a "shell" of space in which the electron is likely to be found. Similarly, Earth's atmosphere has different layers (such as the troposphere, stratosphere, and mesosphere) that separate gases according to their density and temperature.	hydrogen electron's orbital	How is hydrogen electron's orbital analogous to earth’s atmosphere?
The analogy between the hydrogen electron's orbital and Earth's atmosphere is that they are both two-dimensional.	hydrogen electron's orbital	How is hydrogen electron's orbital analogous to earth’s atmosphere?
The analogy between the hydrogen electron's orbital and Earth's atmosphere is that they are both in a state of equilibrium. The hydrogen electron's orbital is in a state of equilibrium because it is constantly being pulled by the proton's nucleus and it is also constantly pushing away from the nucleus. This creates a balance between the two forces and keeps the electron in its orbit. Earth's atmosphere is also in a state of equilibrium because it is constantly being pushed down by gravity and it is also constantly being pushed up by atmospheric pressure. This creates a balance between the two forces and keeps the atmosphere in place.	hydrogen electron's orbital	How is hydrogen electron's orbital analogous to earth’s atmosphere?
The first line of defense in the body is analogous to a police station because it is responsible for preventing anything from entering or leaving the body.	first line of defense in the body	How is first line of defense in the body analogous to police station?
The first line of defense in the body is analogous to a police station because it is the first line of defense against possible invasion by outside organisms.	first line of defense in the body	How is first line of defense in the body analogous to police station?
A police station is the first line of defense in a city or town. It is where citizens go to report crimes and where law enforcement officers work to investigate and prevent crime. The body's first line of defense is also responsible for preventing infections and other dangers from entering the body. This includes things like the skin, mucous membranes, saliva, tears, and enzymes in sweat.	first line of defense in the body	How is first line of defense in the body analogous to police station?
A police station is the first line of defense in a community. It is where people go to report crimes and access other law enforcement services. The body's first line of defense is also its front line, responsible for stopping most invaders from entering the body. This includes the skin, mucous membranes, tears, saliva, and digestive juices.	first line of defense in the body	How is first line of defense in the body analogous to police station?
The first line of defense in the body is analogous to a police station because they are both responsible for protecting the body from outside threats. The police station is responsible for keeping criminals out of the city, and the first line of defense in the body is responsible for keeping pathogens out of the body.	first line of defense in the body	How is first line of defense in the body analogous to police station?
Macrophages are analogous to guards in that they are both responsible for the security of their respective areas. Macrophages protect the body from infection and foreign materials, while guards protect property and people.	macrophages	How is macrophages analogous to guards?
Macrophages act as the body's first line of defense against infection and disease. They are analogous to guards in that they protect the body from invasion by foreign organisms.	macrophages	How is macrophages analogous to guards?
Macrophages are analogous to guards in that they protect the body from infection and other harmful invaders. Macrophages are also responsible for clearing debris and apoptotic cells from the tissue.	macrophages	How is macrophages analogous to guards?
Macrophages are analogous to guards because they act as the first line of defense against infection and injury.	macrophages	How is macrophages analogous to guards?
Macrophages are analogous to guards in that they protect the body from infection and foreign material.	macrophages	How is macrophages analogous to guards?
A constable is a police officer who patrols a specific area. A t-helper cell is a type of white blood cell that helps the body fight infection.	t-helper cells	How is t-helper cells analogous to constables?
T-helper cells are analogous to constables in that they are both responsible for maintaining law and order within their respective domains. In the case of t-helper cells, this means ensuring that the body's immune system is functioning properly. Constables, meanwhile, are responsible for maintaining public order and safety.	t-helper cells	How is t-helper cells analogous to constables?
T-helper cells are analogous to constables in that they are both responsible for maintaining order within their respective systems. In the case of t-helper cells, this involves ensuring that the immune system functions properly and attacking any invading pathogens. Constables, meanwhile, are responsible for maintaining law and order within society.	t-helper cells	How is t-helper cells analogous to constables?
A constable is a police officer who patrols an area and helps maintain law and order. T-helper cells are white blood cells that help the body fight infection. They patrol the body and help maintain healthy tissue.	t-helper cells	How is t-helper cells analogous to constables?
Just as constables are responsible for maintaining law and order in a community, t-helper cells are responsible for activating the immune response to defend the body against infection or disease.	t-helper cells	How is t-helper cells analogous to constables?
B-lymphocytes are analogous to police inspector because they both protect the body from outside threats.	b-lymphocytes	How is b-lymphocytes analogous to police inspector?
A police inspector is responsible for investigating crimes and gathering evidence. B-lymphocytes are responsible for detecting and destroying pathogens in the body. Like a police inspector, they gather information (in this case, from antigens) to identify threats to the body and mount an immune response.	b-lymphocytes	How is b-lymphocytes analogous to police inspector?
B-lymphocytes are analogous to police inspectors because they are both responsible for investigating and apprehending criminals.	b-lymphocytes	How is b-lymphocytes analogous to police inspector?
B-lymphocytes are analogous to a police inspector because they are both responsible for investigating crimes and ensuring that the law is followed.	b-lymphocytes	How is b-lymphocytes analogous to police inspector?
B-lymphocytes are analogous to police inspector in that they are both responsible for investigating and preventing crime. B-lymphocytes play a key role in the immune system by identifying and destroying invading pathogens, while police inspectors investigate crimes and work to prevent them from happening in the first place.	b-lymphocytes	How is b-lymphocytes analogous to police inspector?
Cytotoxic T-lymphocytes are analogous to action force because they both have the ability to destroy cells.	cytotoxic t-lymphocytes	How is cytotoxic t-lymphocytes analogous to action force?
Cytotoxic T-lymphocytes are analogous to action force because they are both able to kill other cells.	cytotoxic t-lymphocytes	How is cytotoxic t-lymphocytes analogous to action force?
Cytotoxic t-lymphocytes are analogous to action force because they both play a role in the immune system. Cytotoxic t-lymphocytes specifically destroy cells that are infected or have been damaged, while action force is responsible for the movement of objects.	cytotoxic t-lymphocytes	How is cytotoxic t-lymphocytes analogous to action force?
Cytotoxic t-lymphocytes are analogous to the action force in that they are both necessary for the body to function properly. Cytotoxic t-lymphocytes kill cancer cells and other infected cells, while the action force allows muscles to move and organs to function.	cytotoxic t-lymphocytes	How is cytotoxic t-lymphocytes analogous to action force?
Cytotoxic T-lymphocytes are analogous to action force because they both have the ability to destroy other cells. Cytotoxic T-lymphocytes specifically target and kill cancer cells, while action force can be used to move or break objects.	cytotoxic t-lymphocytes	How is cytotoxic t-lymphocytes analogous to action force?
In both cases, there is a group of people (bacteria or colonists) that are seeking to expand their territory and take over new land. In both cases, there is typically some resistance from the people who already live in the area. And in both cases, there can be negative consequences for the local population if the invaders are successful.	invasion of bacterias	How is invasion of bacterias analogous to colonial invasion in a country?
Just as invading armies can conquer and occupy new territory, bacteria can invade and colonize new parts of the body, where they can cause infection.	invasion of bacterias	How is invasion of bacterias analogous to colonial invasion in a country?
In both cases, there is an influx of people or things into a territory where they are not wanted or are in competition with the local inhabitants. In the case of bacteria, they may invade and take over the tissue of another organism, often causing disease. In the case of colonial invasion, settlers from other countries may come to live in a new land, taking over the resources and displacing the native people.	invasion of bacterias	How is invasion of bacterias analogous to colonial invasion in a country?
The analogy between bacterial invasion and colonial invasion in a country is that they are both examples of an outside force taking over a territory. In the case of bacteria, they invade and take over an organism's cells; in the case of colonial invasion, Europeans invaded and took over land belonging to Native Americans.	invasion of bacterias	How is invasion of bacterias analogous to colonial invasion in a country?
In both cases, there is an influx of new people or things into a territory where they are not previously present. In the case of bacteria, this can lead to the spread of disease if the invading organisms are pathogenic. In the case of colonialism, this can lead to social and political upheaval as the newcomers attempt to assert their dominance over the existing population.	invasion of bacterias	How is invasion of bacterias analogous to colonial invasion in a country?
In an assembly line, a worker takes a piece of metal and attaches it to another piece of metal. The end result is a car. In an action potential, ions flow into and out of the axon. This creates an electrical current that travels down the axon. This current causes the release of neurotransmitters at the synapse. The end result is communication between neurons.	action potential	How is action potential analogous to assembly line?
The action potential is analogous to an assembly line because it moves information in a systematic way. The action potential starts at the neuron's cell body and travels down the axon to the synapse. At the synapse, the message is transmitted across to the next neuron.	action potential	How is action potential analogous to assembly line?
In a factory, products are assembled on an assembly line. In each step of the process, a worker completes a specific task. The product moves down the line as each worker adds a new component.An action potential is similar to an assembly line because it is a sequential series of events. A neuron fires when it reaches threshold and this triggers another event downstream until the signal propagates to the terminal buttons.	action potential	How is action potential analogous to assembly line?
An action potential is analogous to an assembly line because it is a repetitive, step-by-step process that produces a result.	action potential	How is action potential analogous to assembly line?
The action potential is analogous to an assembly line because it is a sequence of events that occur in a specific order.	action potential	How is action potential analogous to assembly line?
The experiment of chromatography is analogous to two cars taking a day trip in that both are methods of separation. The cars are the mobile phase and the highway is the stationary phase.	experiment of chromatography	How is experiment of chromatography analogous to two cars taking a day trip?
The experiment of chromatography is analogous to two cars taking a day trip in that they are both methods of transportation.	experiment of chromatography	How is experiment of chromatography analogous to two cars taking a day trip?
The experiment of chromatography is analogous to two cars taking a day trip in the following ways: 1. Both the cars and the chromatograph use fuels (gasoline and solvent, respectively) to move them forward. 2. The distance each car travels is determined by how much fuel it has (the amount of solvent passed through the column). 3. Cars can take different routes, as can chromatographs (each run produces a unique set of data). 4. There are always delays along the way (the time it takes for each component of the mixture to travel through the column). 5. The destination for both trips is ultimately reached at the end (data analysis provides information about what compounds were in the sample).	experiment of chromatography	How is experiment of chromatography analogous to two cars taking a day trip?
The cars are analogous to the mobile phase and stationary phase, respectively. The day trip is analogous to the separation of the components of a mixture.	experiment of chromatography	How is experiment of chromatography analogous to two cars taking a day trip?
The experiment of chromatography is analogous to two cars taking a day trip because they are both journeys that involve different forms of transportation.	experiment of chromatography	How is experiment of chromatography analogous to two cars taking a day trip?
Just as cars need to be refueled with gasoline in order to keep running, stars use up their fuel over time and eventually die. The main-sequence lifetime of a star is analogous to how long a car can run on its original fuel tank. Once the star runs out of hydrogen gas, it will no longer be able to produce energy via nuclear fusion and will slowly die.	main-sequence lifetimes of stars	How is main-sequence lifetimes of stars analogous to how long a car can run?
A car can only run as long as it has a combustible material to fuel it. A star will only burn for as long as it has hydrogen gas to fuse into helium.	main-sequence lifetimes of stars	How is main-sequence lifetimes of stars analogous to how long a car can run?
A car has a finite amount of fuel that it can use to run. A star also has a finite amount of nuclear fuel, which determines how long it can burn. The main-sequence lifetime of a star is the time it spends burning hydrogen in its core.	main-sequence lifetimes of stars	How is main-sequence lifetimes of stars analogous to how long a car can run?
The main sequence lifetimes of stars are analogous to how long a car can run in that they are both limited by the amount of fuel that is available. In the case of a star, this fuel is hydrogen gas. Once all the hydrogen gas has been used up, the star will no longer be able to generate energy and it will die.	main-sequence lifetimes of stars	How is main-sequence lifetimes of stars analogous to how long a car can run?
A car can run for a certain amount of time until it runs out of gas. A star will use up its hydrogen fuel and then die.	main-sequence lifetimes of stars	How is main-sequence lifetimes of stars analogous to how long a car can run?
The nucleus is analogous to the brain in that they are both responsible for controlling the body's functions. The brain controls the body's movements and sensory perceptions, while the nucleus controls cell reproduction and metabolism.	nucleus	How is nucleus analogous to brain?
A factory manager is responsible for the operations of a factory. They make sure that the machines are running properly, the workers are doing their job, and that the products are being made correctly. The nucleus is responsible for the operations of a cell. It makes sure that the cells are running properly, the organelles are doing their job, and that correct products are being made.	nucleus	How is nucleus analogous to factory manager?
A nucleus is analogous to a school principal in that it is the central authority in charge of the organization.	nucleus	How is nucleus analogous to school principal?
The nucleus is analogous to the brain because it controls all of the activities within the cell. It directs what proteins are made, how much energy the cell produces, and when it reproduces. The brain controls all of the activities within the body and directs what proteins are made, how much energy the body produces, and when it reproduces.	nucleus	How is nucleus analogous to brain?
The nucleus is analogous to the school principal because it is in charge of the operations of the cell.	nucleus	How is nucleus analogous to school principal?
Ribosomes are analogous to hamburger cook because they both use heat to create a final product. Ribosomes use the energy from ATP molecules to create proteins, while hamburgers cook using heat.	ribosomes	How is ribosomes analogous to hamburger cook?
Ribosomes are like hamburger cook because they both use heat to create a product. Ribosomes use the energy from the sun to create proteins while hamburgers cook with heat to make them more palatable.	ribosomes	How is ribosomes analogous to hamburger cook?
Ribosomes are analogous to hamburger cook because they are both responsible for creating something. Ribosomes create proteins while hamburgers cook and create a delicious meal.	ribosomes	How is ribosomes analogous to hamburger cook?
A ribosome is analogous to a school vice-principal in that they are both important for the function of their respective institutions. The vice-principal helps keep things running smoothly at the school, and the ribosomes help translate genetic information into proteins necessary for life.	ribosomes	How is ribosomes analogous to school vice-principal?
Ribosomes are analogous to machines in that they are both able to create new molecules by combining smaller pieces of preexisting molecules.	ribosomes	How is ribosomes analogous to machines?
The golgi apparatus is analogous to container boxes because it processes and packages cellular material into vesicles that are destined for other parts of the cell or for release outside the cell.	golgi apparatus	How is golgi apparatus analogous to container boxes?
The golgi apparatus is analogous to container boxes because it processes and packages materials that are delivered to it from the endoplasmic reticulum.	golgi apparatus	How is golgi apparatus analogous to container boxes?
The Golgi apparatus is analogous to a teacher because it helps to organize and package material that will be sent to other parts of the cell.	golgi apparatus	How is golgi apparatus analogous to teacher?
The golgi apparatus is like container boxes because it processes and packages macromolecules that have been synthesized by the cell. The golgi apparatus receives proteins and lipids from the endoplasmic reticulum, modifies them, and then exports them to various parts of the cell.	golgi apparatus	How is golgi apparatus analogous to container boxes?
The golgi apparatus is analogous to container boxes because it organizes and packages proteins into vesicles that are sent to other parts of the cell.	golgi apparatus	How is golgi apparatus analogous to container boxes?
Lysosomes are analogous to school janitors because they both clean up waste. Lysosomes break down and digest old or damaged cells, while janitors clean up trash and dirt in the school.	lysosomes	How is lysosomes analogous to school janitor?
Lysosomes are analogous to school janitors in that they both break down waste products. Lysosomes break down proteins, carbohydrates, and lipids inside of cells, while janitors break down trash outside of cells.	lysosomes	How is lysosomes analogous to school janitor?
Lysosomes are analogous to school janitors in that they both clean up the messes. Lysosomes break down proteins, lipids, and nucleic acids into smaller molecules that can be recycled or eliminated from the cell. School janitors clean up the messes left by students, such as food wrappers and spilled drinks.	lysosomes	How is lysosomes analogous to school janitor?
The analogy between lysosomes and school janitors is that they are both responsible for clearing away debris. Lysosomes clear away cellular waste products, while janitors clear away trash and dirt from the school premises.	lysosomes	How is lysosomes analogous to school janitor?
Lysosomes are analogy to school janitors because they both clean up messes. Lysosomes break down waste products and recycles them into new molecules while school janitors clean up the messes made by students.	lysosomes	How is lysosomes analogous to school janitor?
A nuclear envelope is analogous to a school's main office in that it is responsible for overseeing all activities within the nucleus of a cell. just as the main office is responsible for managing the day-to-day operations of a school, the nuclear envelope manages all cellular processes that take place inside the nucleus.	nuclear envelope	How is nuclear envelope analogous to school main office?
A nuclear envelope is analogous to a school main office in that they are both places where important decisions are made. The nuclear envelope is the cellular structure that surrounds the nucleus of a cell, and it is responsible for controlling what enters and leaves the nucleus. Similarly, the school main office is responsible for making decisions about things like curriculum and budgeting.	nuclear envelope	How is nuclear envelope analogous to school main office?
The nuclear envelope is analogous to the school main office in that they are both responsible for overseeing different aspects of the organization. The nuclear envelope oversees the activities within the cell nucleus, while the school main office oversees things like attendance, student records, and budgeting.	nuclear envelope	How is nuclear envelope analogous to school main office?
The nuclear envelope is analogous to the school main office in that they are both responsible for overseeing and regulating important activities within their respective domains. The nuclear envelope oversees and regulates the activities taking place within the nucleus, while the school main office oversees and regulates all of the goings-on in the school building.	nuclear envelope	How is nuclear envelope analogous to school main office?
The nuclear envelope is analogous to the school main office in that they are both responsible for maintaining order and communication within their respective domains. The nuclear envelope regulates the passage of molecules into and out of the nucleus, while the main office manages attendance, schedules, and communications among staff and students.	nuclear envelope	How is nuclear envelope analogous to school main office?
Cabinets are storage spaces in a house. Vacuoles are storage spaces inside of cells.	vacuoles	How is vacuoles analogous to cabinets?
Cabinets are storage spaces in a house that can be used to store different items. Vacuoles are storage spaces in cells that can be used to store different items.	vacuoles	How is vacuoles analogous to cabinets?
A cabinet is a piece of furniture that typically contains shelves, drawers, and a countertop. It can be used to store various items. A vacuole is a cellular organelle that also typically contains shelves, drawers, and a countertop. It can be used to store various items, such as nutrients or water.	vacuoles	How is vacuoles analogous to cabinets?
One way to think of vacuoles is as analogous to cabinets. Just as cabinets can be used for storage, vacuoles can be used for storage within cells. Vacuoles are also important for the cell's metabolism and for performing other essential functions.	vacuoles	How is vacuoles analogous to cabinets?
A cabinet is a storage unit with shelves and drawers. It is used to store belongings or other objects. A vacuole is also a storage unit, but it stores chemicals and water in plants.	vacuoles	How is vacuoles analogous to cabinets?
A school secretary is responsible for the organization and communication within a school. Cytoplasm is responsible for the organization and communication within a cell.	cytoplasm	How is cytoplasm analogous to school secretary?
The cytoplasm is analogous to the school secretary because they are both responsible for organizing and managing the activities of their respective entities.	cytoplasm	How is cytoplasm analogous to school secretary?
Cytoplasm is analogous to sandwich stuffing in that they are both fillers. Cytoplasm fills up the cell while sandwich stuffing fills up the sandwich. They also have a similar consistency, being thick and gooey.	cytoplasm	How is cytoplasm analogous to sandwich stuffing?
Cytoplasm is analogous to sandwich stuffing because they are both fillers. Cytoplasm fills up the cell while sandwich stuffing fills up the sandwich.	cytoplasm	How is cytoplasm analogous to sandwich stuffing?
The cytoplasm is analogous to the school secretary in that they are both responsible for organizing and coordinating the activities within their respective domains.	cytoplasm	How is cytoplasm analogous to school secretary?
A chromosome is analogous to a school website in that they are both repositories for information. A chromosome stores genetic information, while a school website stores information about the school such as its curriculum, faculty, and students.	chromosome	How is chromosome analogous to school website?
A chromosome is analogous to a school website in that they are both repositories of information. A chromosome contains the genetic information of an organism, while a school website contains the curriculum and other information about a school.	chromosome	How is chromosome analogous to school website?
A chromosome is analogous to a school website in that they are both informational resources. A chromosome stores genetic information, while a school website stores information about the school, such as its curriculum, faculty, and student body.	chromosome	How is chromosome analogous to school website?
A chromosome is analogous to a school website in that they are both repositories of information. A chromosome stores genetic information, while a school website stores information about the school such as its curriculum, staff, and students.	chromosome	How is chromosome analogous to school website?
Both chromosomes and school websites contain information that is organized in a specific way. For chromosomes, the information is genes that are responsible for various traits. For school websites, the information typically includes course descriptions, teacher bios, student testimonials, and other relevant details.	chromosome	How is chromosome analogous to school website?
Cytosol is analogous to staff because it is both a fluid and a structural component of the cell. Staff is used to support the weight of an object, and cytosol supports the internal components of the cell.	cytosol	How is cytosol analogous to staff?
The cytosol is analogous to staff in that they are both fluid substances that play a role in supporting the organization of the cell. The cytosol surrounds and supports the other cellular components, while staff provides support for musicians playing an orchestral performance.	cytosol	How is cytosol analogous to staff?
Cytosol is analogous to staff in that they are both liquids that support the cells of their respective organisms. Cytosol provides nutrients and oxygen to the cells, while staff members provide guidance and support to the orchestra.	cytosol	How is cytosol analogous to staff?
A staff is an object that can be used to help with walking. It has a long, thin shaft and a large, round head on one end. The other end is typically pointed so it can be pushed into the ground for stability. Cytosol is like a staff because it helps stabilize the cell and provides support.	cytosol	How is cytosol analogous to staff?
Cytosol is analogous to staff because it helps to support the cell and its functions.	cytosol	How is cytosol analogous to staff?
A factory is a place where things are made. A cell is a place where things are made, too - like proteins and other molecules.	cell	How is cell analogous to factory?
A factory can be thought of as a place where things are made. A cell is like a factory because it is a place where things (proteins) are made.	cell	How is cell analogous to factory?
A factory is a place where things are made, and a cell is a place where things are made.	cell	How is cell analogous to factory?
A factory can be thought of as a place where things are made. Similarly, cells are the smallest structural and functional unit of an organism where things (proteins) are made.	cell	How is cell analogous to factory?
A factory is a place where things are made. A cell is a place where things are made.	cell	How is cell analogous to factory?
Vesicles are analogous to transportation facilities in that they provide a way for things to be transported from one place to another. In the case of vesicles, this transport is often within or between cells.	vesicles	How is vesicles analogous to transportation facility?
A vesicle is a small, fluid-filled sac that is used to transport substances within the body. This analogy can be used to describe a transportation facility as a place where goods are transported from one location to another.	vesicles	How is vesicles analogous to transportation facility?
A vesicle is a small, round organelle found in the cytoplasm of cells. Vesicles are similar to transportation facilities because they both help transport things from one place to another inside of a cell.	vesicles	How is vesicles analogous to transportation facility?
A vesicle is a transport facility that shuttles cargo between different parts of the cell.	vesicles	How is vesicles analogous to transportation facility?
A transportation facility is a place where people and goods are transported from one location to another. A vesicle is a small, membrane-bound sac that transports molecules within the cell. So, like a transportation facility, a vesicle transports molecules from one location to another.	vesicles	How is vesicles analogous to transportation facility?
A security guard is a person who is employed to protect property and people. A cell wall is a structure that surrounds the cell membrane and helps to protect the cell from its environment.	cell wall	How is cell wall analogous to security guard?
A factory gate is analogous to a cell wall because both are barriers that protect something from the outside.	cell wall	How is cell wall analogous to factory gate?
Factory gate is analogous to cell wall because they are both physical barriers that keep things in or out. Factory gate controls the entry and exit of people and materials into the factory, while the cell wall controls the entry and exit of nutrients and other molecules into the cell.	cell wall	How is cell wall analogous to factory gate?
A cell wall is analogous to a security guard in that it provides protection for the cells interior. The cell wall is made up of a tough material that helps keep out bacteria and other foreign invaders. It also helps maintain the shape of the cell. Like a security guard, the cell wall is always on duty, protecting the cells contents from harm.	cell wall	How is cell wall analogous to security guard?
A security guard's job is to protect people and property. A cell wall's job is to protect the cell from outside invaders, such as toxins or other cells.	cell wall	How is cell wall analogous to security guard?
A cell analogy to a restaurant might be that the nucleus is the kitchen, the cytoplasm is the dining room, and the mitochondria are the wait staff. Just as in a restaurant, food (nutrients) must be brought in and processed in the kitchen before it can be served to diners in the dining room. In cells, nutrients are carried into and out of cells by proteins embedded in membranes. The wait staff in this analogy would be responsible for getting energy from food (via respiration) to where it is needed throughout the cell.	cells	How is cells analogous to restaurant?
A restaurant is a business that prepares and serves food and drinks to customers in exchange for money. A cell is a small unit of life that performs all the functions necessary for survival.	cells	How is cells analogous to restaurant?
A restaurant is a place where people can buy food to eat. A cell is a place where molecules can buy food to use.	cells	How is cells analogous to restaurant?
Cells are analogous to restaurants in that they both provide a service for others. Cells produce the proteins and other molecules that organisms need to survive, while restaurants provide food for those organisms.	cells	How is cells analogous to restaurant?
A cell is analogous to a restaurant in that it is a place where people can go to eat.	cells	How is cells analogous to restaurant?
The cell membrane is analogous to the restaurant doors because they both control what goes in and out of the system. The cell membrane controls what goes into and out of the cells while the restaurant doors control what goes into and out of the restaurant.	cell membrane	How is cell membrane analogous to restaurant doors?
A cell membrane is analogous to windows because they are both thin layers that allow something to pass through them. In the case of a window, light passes through it. In the case of a cell membrane, molecules can pass in and out of the cell.	cell membrane	How is cell membrane analogous to windows?
A cell membrane is analogous to skin in that they are both barriers. The cell membrane separates the inside of the cell from the outside environment, while skin separates the internal organs from the external environment. Both membranes also play a role in protecting the body from pathogens and other harmful substances.	cell membrane	How is cell membrane analogous to skin?
A cell membrane is analogous to restaurant doors in that they are both barriers between two different areas. In the case of a cell, the membrane separates the inside of the cell from its environment. In the case of a restaurant, the door separates the customer area from the kitchen.	cell membrane	How is cell membrane analogous to restaurant doors?
A cell membrane is analogous to windows because they both allow things to pass in and out.	cell membrane	How is cell membrane analogous to windows?
Golgi body is analogous to front counter because they are both responsible for handling and processing customer orders.	golgi body	How is golgi body analogous to front counter?
Golgi body is analogous to front counter because they are both used for storage. The Golgi body stores proteins and the front counter store products.	golgi body	How is golgi body analogous to front counter?
The Golgi body is an organelle found in the cytoplasm of eukaryotic cells. It is analogous to a front counter because it helps with the packaging and shipping of products from the cell.	golgi body	How is golgi body analogous to front counter?
A golgi body is analogous to a front counter because they are both responsible for delivering products to their respective destinations. The golgi body delivers products to the cell membrane, while the front counter delivers products to customers.	golgi body	How is golgi body analogous to front counter?
A front counter is a place in a store where customers can buy things. The golgi body is analogous to the front counter because it is a place where things are bought and processed.	golgi body	How is golgi body analogous to front counter?
Capacitance is analogous to heat content in that they are both measures of the ability of a system to store energy. Capacitance stores energy in an electric field, while heat content stores energy in thermal fluctuations of molecules.	capacitance	How is capacitance analogous to heat content?
Capacitance is analogous to heat content in that they are both forms of energy. Capacitance is the ability to store electrical energy, while heat content is the ability to store thermal energy.	capacitance	How is capacitance analogous to heat content?
Capacitance is analogous to heat content in that it is a measure of the ability of a system to store energy.	capacitance	How is capacitance analogous to heat content?
Capacitance is analogous to heat content in that they are both forms of energy storage. Capacitance stores electrical energy while heat content stores thermal energy.	capacitance	How is capacitance analogous to heat content?
The capacitance of a capacitor is analogous to the heat content of a substance. Just as capacitance stores energy in an electric field, heat content stores energy in the motion of particles.	capacitance	How is capacitance analogous to heat content?
Electric current is analogous to water tank because they are both forms of energy. Electric current flows through a conductor, just as water flows through a pipe. The voltage (pressure) of the electric current is analogous to the water pressure in the tank.	electric current	How is electric current analogous to water tank?
Just as water can flow through a pipe, electric current can flow through a wire. The amount of water in the tank is analogous to the voltage (amount of pressure) in the electrical circuit. The size of the pipe is analogous to the resistance in the electrical circuit.	electric current	How is electric current analogous to water tank?
The electric current is analogous to the water tank because they are both fluids that flow.	electric current	How is electric current analogous to water tank?
Electric current is analogous to a water tank in that they are both forms of energy. Electricity flows through a wire much like water flows through a pipe. Just as water can be used to power machines, so can electricity.	electric current	How is electric current analogous to water tank?
The electric current is analogous to the water tank because they are both able to store and transfer energy.	electric current	How is electric current analogous to water tank?
Climbing a staircase is analogous to voltage because it involves going up or down. Voltage is the measure of how much work it takes to move electricity through a material, and just like climbing stairs, the more steps there are (the higher the voltage), the harder it is to get up or down.	voltage	How is voltage analogous to climbing a staircase?
One way to think of voltage is as if it is represented by the height of a staircase. The higher the voltage, the more energy there is available to push electrons up the stairs.	voltage	How is voltage analogous to climbing a staircase?
Voltage is analogous to climbing a staircase because it is an increase in potential energy.	voltage	How is voltage analogous to climbing a staircase?
Climbing a staircase is analogous to voltage because it takes energy to climb the stairs and the higher you go, the more energy you need. Voltage is similar because it takes energy to move electrons through a circuit and the higher the voltage, the more energy is needed.	voltage	How is voltage analogous to climbing a staircase?
 analogy: Voltage is analogous to climbing a staircase. Just as you must take one step at a time when ascending a staircase, you must apply voltage in increments to power an electronic device.	voltage	How is voltage analogous to climbing a staircase?
In football, players specialize in playing a certain position on the field. For example, quarterbacks throw the ball, linemen protect the quarterback and block for running backs, and receivers catch passes. These players must communicate with each other to be successful. They need to know what their teammates are going to do so they can all work together as a team.In cells, proteins specialize in doing certain jobs. For example, some proteins help transport things around the cell while others help build new molecules. Proteins must also communicate with each other to carry out their tasks effectively.	specialization and communication in a cell	How is specialization and communication in a cell analogous to football?
A football team is composed of specialists who must communicate with one another in order to achieve a common goal. The quarterback, for example, must be able to throw the ball to the receiver and then trust that the receiver will catch it. Likewise, cells are composed of specialized proteins that must communicate with one another in order to carry out complex tasks.	specialization and communication in a cell	How is specialization and communication in a cell analogous to football?
A football team is a specialized group of people who communicate with one another in order to win a game. A cell is also a specialized group of people who communicate with one another in order to carry out the functions of life.	specialization and communication in a cell	How is specialization and communication in a cell analogous to football?
In football, players specialize in different positions and communicate with one another to create plays. In a cell, proteins specialize in different functions and communicate with each other to carry out cellular processes.	specialization and communication in a cell	How is specialization and communication in a cell analogous to football?
In football, players specialize in different positions and must communicate with one another to be successful. In the same way, cells specialize in different functions and must communicate with each other to carry out all the necessary cellular processes.	specialization and communication in a cell	How is specialization and communication in a cell analogous to football?
Kirchoff's voltage law is analogous to hiking in that it helps people understand and navigate their surroundings. In the same way that hikers use a map and compass to find their way, electrical engineers use Kirchoff's voltage law to understand how electricity flows through circuits.	kirchoff's voltage law	How is kirchoff's voltage law analogous to hiking?
When hiking, the total potential energy of a hiker and her pack is the sum of the gravitational potential energy and the kinetic energy. The gravitational potential energy is proportional to the mass of an object multiplied by the height difference between where it is located and its lowest point. The kinetic energy is equal to one half times the mass multiplied by the square of its velocity.	kirchoff's voltage law	How is kirchoff's voltage law analogous to hiking?
If you are hiking and come to a junction in the path, you need to determine which path will take you to your destination. To do this, you compare the voltage (or potential energy) of each path. The path with the highest voltage is the one you should take. This is analogous to Kirchoff's Voltage Law, which states that the sum of all voltages around a closed loop must be zero.	kirchoff's voltage law	How is kirchoff's voltage law analogous to hiking?
Kirchoff's voltage law is analogous to hiking in that they are both ways of exploring and discovering new things. Hiking allows you to explore the natural scenery and Kirchoff's voltage law lets you explore the behavior of electrical circuits.	kirchoff's voltage law	How is kirchoff's voltage law analogous to hiking?
Kirchoff's Voltage Law is analogous to hiking because it states that the total voltage in a circuit is equal to the sum of the voltages across each individual component in the circuit. This analogy can be used to help explain how electricity works by imagining that hikers are travelling through a series of mountains and valleys. The total elevation change (voltage) experienced by the hikers is the sum of all of the individual changes in elevation (voltages).	kirchoff's voltage law	How is kirchoff's voltage law analogous to hiking?
Density waves are analogous to traffic jams on a highway because they are both caused by an accumulation of objects in one area. In the case of a traffic jam, cars are the objects and in the case of a density wave, atoms or molecules are the objects.	nature of a density wave	How is nature of a density wave analogous to traffic jam on a highway?
A density wave is created when a large number of cars move slowly on the highway. This creates a long line of traffic that backs up as it moves down the road. The same thing happens with a density wave in space. A large number of stars will move slowly, creating a long line of stars that stretch across the galaxy.	nature of a density wave	How is nature of a density wave analogous to traffic jam on a highway?
A density wave is analogous to a traffic jam on a highway because it causes the particles in a system to clump together. This can be seen in both systems as cars slow down or stop and the congestion builds up.	nature of a density wave	How is nature of a density wave analogous to traffic jam on a highway?
A density wave is analogous to a traffic jam on a highway because it creates congestion and slows down the flow of traffic.	nature of a density wave	How is nature of a density wave analogous to traffic jam on a highway?
A density wave on a highway is analogous to a traffic jam. Just as cars in a traffic jam slow down and bunch up, particles in a condensed matter system form clumps that move more slowly than the surrounding material.	nature of a density wave	How is nature of a density wave analogous to traffic jam on a highway?
Enzymes are analogous to keyholes because they are both responsible for facilitating a process. Enzymes facilitate chemical reactions, while keyholes facilitate the opening of locks.	enzymes	How is enzymes analogous to key hole?
Enzymes are analogous to keyholes because they are both essential in the process of something happening. In the case of enzymes, they are necessary for chemical reactions to take place. Without enzymes, these reactions would not occur as quickly or at all. Similarly, keyholes are necessary for unlocking doors so that people can enter and exit a building.	enzymes	How is enzymes analogous to key hole?
Enzymes are analogous to keyholes because they are both responsible for starting and catalyzing specific processes. Enzymes help to break down food in the stomach, just as a key helps to unlock a door.	enzymes	How is enzymes analogous to key hole?
Enzymes are analogous to keyholes because they are both responsible for facilitating activity. Enzymes unlock the chemical potential in substrates, while keyholes allow access to locked areas.	enzymes	How is enzymes analogous to key hole?
Enzymes are analogous to keyholes in that they are both responsible for the process of unlocking something. In the case of enzymes, they unlock the chemical bonds in molecules so that they can be converted into new substances.	enzymes	How is enzymes analogous to key hole?
The human active memory system is analogous to a computer in that both systems store and process information. The human active memory system differs from a computer in that the human active memory system can create new memories, while computers cannot.	human active memory system	How is human active memory system analogous to computer?
The human active memory system is analogous to a computer in that they are both able to store and recall information.	human active memory system	How is human active memory system analogous to computer?
The human active memory system can be analogous to a computer in that they are both able to store and recall information. Additionally, both the human active memory system and a computer can be used for problem solving.	human active memory system	How is human active memory system analogous to computer?
The human active memory system is analogous to a computer in that both are able to store and recall information.	human active memory system	How is human active memory system analogous to computer?
Computer systems are designed to store and process information. The analogy between human active memory system and computer can be drawn on the basis of following features:1. Both human active memory system and computer use some form of storage to retain information. In case of computer, this is usually in the form of electronic circuits, while in humans it is typically in the brain in the form of neurons.2. Both human active memory system and computer use a processor to access stored information and carry out logical operations on it. For humans, this processing takes place in the brain, while for computers it occurs through software running on a microprocessor or central processing unit (CPU). 3. Both human active memory system and computer can output information as well as receive input from other sources. In humans, sensory organs provide input into the brain, while for computers various forms of input/output (I/O) devices are used such as keyboards, mice etc.	human active memory system	How is human active memory system analogous to computer?
The rate-determining step of a reaction is analogous to the slowest moving car in traffic. Just as the slowest car determines the overall speed of traffic, the rate-determining step of a reaction determines the overall speed of the reaction.	rate-determining step of a reaction	How is rate-determining step of a reaction analogous to slowest moving car in traffic?
One can think about the rate-determining step of a reaction as being analogous to buying stamps at the post office, when there is a long line of customers. In this analogy, the "reaction" can be thought of as the process of people waiting in line to buy stamps, and the "rate-determining step" can be thought of as the point at which most people are deciding whether or not to wait in line any longer. Just like with the reaction, if there are too many people in line, then it will take longer for everyone to get their stamps (or in this analogy, it will take longer for everyone to get through the checkout).	rate-determining step of a reaction	How is rate-determining step of a reaction analogous to buying stamps at the post office, when there is a long line of customers?
If you are in traffic and looking at the cars in front of you, the car that is moving the slowest is analogous to the rate-determining step of a reaction.	rate-determining step of a reaction	How is rate-determining step of a reaction analogous to slowest moving car in traffic?
The rate-determining step is analogous to the slowest moving car in traffic because it is the step that controls the speed of the reaction.	rate-determining step of a reaction	How is rate-determining step of a reaction analogous to slowest moving car in traffic?
The rate-determining step of a reaction is analogous to the slowest moving car in traffic. The rate-determining step is the step in a reaction that determines how fast the reaction will proceed. This analogy can be used to help understand how reactions work and why they occur at different rates.	rate-determining step of a reaction	How is rate-determining step of a reaction analogous to slowest moving car in traffic?
Column chromatography is analogous to separating bees and wasps because it is a way to separate two different substances. Column chromatography uses a column filled with particles that are the same size as the substance you want to separate. When you put the substances in the column, they will move through it at different speeds. The faster a substance moves through the column, the more pure it is.	column chromatography	How is column chromatography analogous to separating bees and wasps?
Column chromatography is analogous to separating bees and wasps because it separates the two types of insects by their physical properties. Column chromatography uses a column filled with a porous material, like silica gel, that allows smaller molecules to move through it more quickly than larger molecules. This allows different compounds in a mixture to be separated based on how fast they can move through the column. Just like bees and wasps have different sizes, some compounds in a mixture will travel through the column faster than others, allowing them to be separated.	column chromatography	How is column chromatography analogous to separating bees and wasps?
Column chromatography is analogous to separating bees and wasps because it can be used to separate two different substances based on their physical properties.	column chromatography	How is column chromatography analogous to separating bees and wasps?
Column chromatography is analogous to separating bees and wasps because they are both using a physical property of the object to separate them.	column chromatography	How is column chromatography analogous to separating bees and wasps?
Just like separating bees and wasps, column chromatography separates molecules by size. The smaller molecules travel through the column faster than the larger ones.	column chromatography	How is column chromatography analogous to separating bees and wasps?
Dynamic chemical equilibrium is analogous to two jugglers because in both cases there is a balance between the objects being juggled. In the case of two jugglers, if one throws more balls than the other then eventually they will reach a balance where each juggler is juggling the same number of balls. In the case of chemical equilibrium, if one molecule gains or loses energy faster than another molecule then eventually they will reach a balance where each molecule has the same amount of energy.	dynamic chemical equilibrium	How is dynamic chemical equilibrium analogous to two jugglers?
Dynamic chemical equilibrium is analogous to two jugglers because in both cases there are multiple objects that are moving around and being juggled. In the case of the jugglers, there are multiple balls that they are juggling. In the case of dynamic chemical equilibrium, there are multiple molecules that are moving around and being balanced.	dynamic chemical equilibrium	How is dynamic chemical equilibrium analogous to two jugglers?
In both cases, the objects are in a state of balance.	dynamic chemical equilibrium	How is dynamic chemical equilibrium analogous to two jugglers?
In both cases, there is a constant flow of material in one direction that is balanced by an opposing flow of material. In the case of jugglers, the balls represent the molecules and the hands represent the forces between them.	dynamic chemical equilibrium	How is dynamic chemical equilibrium analogous to two jugglers?
In dynamic chemical equilibrium, two jugglers are balancing balls on their heads. The analogy can be drawn further by considering the position of each ball to be analogous to a molecule in a state of equilibrium. Just as the jugglers must constantly adjust their movements to keep the balls balanced, so must the molecules continually rearrange themselves to maintain equilibrium.	dynamic chemical equilibrium	How is dynamic chemical equilibrium analogous to two jugglers?
A vacuole is analogous to a storage bag because it can store things inside of it.	vacuole	How is vacuole analogous to storage bags?
The vacuole is like a storage bag because it stores water, food, and other materials.	vacuole	How is vacuole analogous to storage bags?
A vacuole is a storage bag because it stores water and other nutrients until the plant needs them.	vacuole	How is vacuole analogous to storage bags?
A vacuole is an organelle in a eukaryotic cell that is analogous to a storage bag.	vacuole	How is vacuole analogous to storage bags?
The analogy between vacuoles and storage bags is that they are both containers used to store things. Vacuoles are usually filled with water or other molecules, while storage bags can be filled with a variety of items, such as food or clothes.	vacuole	How is vacuole analogous to storage bags?
The analogy between transport vesicles and delivery trucks is that they are both vehicles used to transport something from one place to another. In the case of transport vesicles, they are transporting proteins and other molecules around the cell. Delivery trucks are used to transport goods such as food or merchandise from businesses to consumers.	transport vesicles	How is transport vesicles analogous to delivery truck?
A transport vesicle is analogous to a delivery truck because they are both used to deliver something. In the case of a transport vesicle, it delivers molecules or proteins from one part of the cell to another. Delivery trucks deliver packages and other items from one place to another.	transport vesicles	How is transport vesicles analogous to delivery truck?
The analogy between transport vesicles and delivery trucks is that they are both vehicles used to carry something from one place to another. In the case of transport vesicles, they are used to carry cargo (molecules) from the cell's cytoplasm to other parts of the cell or outside the cell. Delivery trucks are used to carry goods (e.g., products, food, etc.) from businesses to customers' homes or places of business.	transport vesicles	How is transport vesicles analogous to delivery truck?
A delivery truck is analogous to transport vesicles because they are both used to deliver something. The delivery truck delivers goods to a store, while the transport vesicles deliver molecules to different parts of the cell.	transport vesicles	How is transport vesicles analogous to delivery truck?
A delivery truck is an example of a type of vehicle that can be used for transport. Transport vesicles are analogous to delivery trucks because they both play a role in transporting something from one place to another.	transport vesicles	How is transport vesicles analogous to delivery truck?
Proto-oncogenes are analogous to car accelerators because they both promote cell growth. Proto-oncogenes are genes that can turn into cancer-causing oncogenes if they mutate. Car accelerators make cars go faster, and proto-oncogenes make cells grow faster.	proto-oncogenes	How is proto-oncogenes analogous to car accelerator?
A proto-oncogene is an inactive gene that, when mutated, can become an oncogene. This is analogous to a car accelerator becoming stuck in the "on" position, causing the car to speed up uncontrollably.	proto-oncogenes	How is proto-oncogenes analogous to car accelerator?
A proto-oncogene is a gene that has the potential to become an oncogene. An oncogene is a gene that has been altered so that it can cause cancer. Proto-oncogenes are analogous to car accelerators because they both have the potential to cause something to happen more quickly. In the case of proto-oncogenes, this means that they have the potential to turn into oncogenes and cause cancer.	proto-oncogenes	How is proto-oncogenes analogous to car accelerator?
A proto-oncogene is a gene that, when mutated, can lead to cancer. It is analogous to a car accelerator because it can speed up the process of tumor formation.	proto-oncogenes	How is proto-oncogenes analogous to car accelerator?
Proto-oncogenes are analogous to car accelerators in that they both activate something. Proto-oncogenes activate the growth of cancer cells, while car accelerators activate the speed of a car.	proto-oncogenes	How is proto-oncogenes analogous to car accelerator?
An oncogene is analogous to a car accelerator stuck in the down position because it can cause cells to divide uncontrollably, leading to cancer.	oncogenes	How is oncogenes analogous to car accelerator stuck in down position?
Just as a car accelerator stuck in the down position can cause a car to speed out of control, oncogenes that are constantly activated can cause cells to grow and divide uncontrollably, leading to cancer.	oncogenes	How is oncogenes analogous to car accelerator stuck in down position?
The oncogene analogy to a car accelerator stuck in the down position is that it causes cells to grow and divide uncontrollably, leading to cancer.	oncogenes	How is oncogenes analogous to car accelerator stuck in down position?
An oncogene is analogous to a car accelerator stuck in the down position because it can cause cells to grow and divide uncontrollably, leading to cancer.	oncogenes	How is oncogenes analogous to car accelerator stuck in down position?
An oncogene is analogous to a car accelerator stuck in the down position because it causes cells to grow and divide out of control, leading to cancer.	oncogenes	How is oncogenes analogous to car accelerator stuck in down position?
The analogy between tumor suppressor genes and car brakes is that they are both responsible for stopping something from happening. In the case of cars, the brakes stop the car from moving forward; in the case of tumor suppressor genes, they stop tumors from growing and spreading.	tumor suppressor genes	How is tumor suppressor genes analogous to car brakes?
The analogy of tumor suppressor genes to car brakes is that they are both responsible for limiting the amount of damage that is done. In the case of a car, the brakes are used to stop the car from going too fast and crashing into something. In the case of tumor suppressor genes, they are used to stop tumors from growing out of control and damaging other tissues in the body.	tumor suppressor genes	How is tumor suppressor genes analogous to car brakes?
Tumor suppressor genes are analogous to car brakes because they both help to prevent something from going too fast or out of control. In the case of tumor suppressor genes, they help to prevent tumors from developing and growing. Just as car brakes can wear down over time and eventually need to be replaced, tumor suppressor genes can also become damaged or mutated over time and eventually stop working. This is why it is important for people to get regular cancer screenings, so that any potential problems with these genes can be detected early on.	tumor suppressor genes	How is tumor suppressor genes analogous to car brakes?
The analogy between tumor suppressor genes and car brakes is that both are essential for the normal functioning of the system but can also fail, leading to disastrous consequences. In the case of a car, if the brake pads wear down too much, the metal brake disk will grind against the metal housing, causing excessive heat and damage that can lead to a total failure of braking ability. In cancer cells, if one or more tumor suppressor genes are mutated or deleted, then DNA replication and cell division can spiral out of control, leading to uncontrolled growth and ultimately cancer.	tumor suppressor genes	How is tumor suppressor genes analogous to car brakes?
A brake is a device used to slow or stop a moving object. Tumor suppressor genes are analogous to brakes because they help to stop the growth of tumors.	tumor suppressor genes	How is tumor suppressor genes analogous to car brakes?
Brittle software is analogous to jenga in that they are both fragile. Jenga is fragile because if one piece is removed, the whole tower falls. Brittle software is fragile because if one component fails, the whole system can fail.	brittle software	How is brittle software analogous to jenga?
Brittle software is like jenga in that it can easily collapse if too many changes are made at once. Just as with jenga, the slightest mistake can cause a lot of damage and bring the entire system down. This makes brittle software difficult to maintain and update, leading to frustration for users and developers alike.	brittle software	How is brittle software analogous to jenga?
Brittle software is analogous to jenga in that they are both delicate and can easily be broken.	brittle software	How is brittle software analogous to jenga?
Brittle software is analogous to jenga because it is easily broken and can be difficult to fix. Just like with a game of jenga, if one piece of brittle software is removed or changed, the entire system can become unstable.	brittle software	How is brittle software analogous to jenga?
Brittle software is analogous to jenga because it is unstable and easily falls apart.	brittle software	How is brittle software analogous to jenga?
A resonance hybrid is analogous to a rhinoceros because it is composed of two or more different atoms that are covalently bonded together.	resonance hybrid	How is resonance hybrid analogous to rhinoceros?
A resonance hybrid is analogous to a rhinoceros in that they are both made up of multiple parts that work together. The resonance hybrid is made up of the atomic orbitals of the atoms involved in the bond, and the rhinoceros is made up of its horn, body, and legs.	resonance hybrid	How is resonance hybrid analogous to rhinoceros?
A rhinoceros has a large horn on its nose. A resonance hybrid is an atom with more than one electron in its outer shell.	resonance hybrid	How is resonance hybrid analogous to rhinoceros?
A rhinoceros has a horn on its nose. A resonance hybrid is an atom with more than one type of electron orbit, or "shell." The horns on a rhinoceros are analogous to the different types of electron orbits in a resonance hybrid.	resonance hybrid	How is resonance hybrid analogous to rhinoceros?
A resonance hybrid is analogous to a rhinoceros in that they are both large, bulky creatures.	resonance hybrid	How is resonance hybrid analogous to rhinoceros?
When you see a firefly in a dark room, it looks like it's emitting its own light. In reality, the insect is reflecting light from an external source (e.g., a lamp). A wave mechanical model of atoms is analogous to fireflies in a dark room because both models involve objects that emit or reflect light.	wave mechanical model	How is wave mechanical model analogous to firefly in a dark room?
A wave mechanical model is analogous to a firefly in a dark room because they are both examples of something that can be seen but not touched.	wave mechanical model	How is wave mechanical model analogous to firefly in a dark room?
In a dark room, if you see one firefly, you can assume there are many more. This is analogous to the wave mechanical model of matter which states that atoms are not isolated points, but form continuous waves.	wave mechanical model	How is wave mechanical model analogous to firefly in a dark room?
In a dark room, if you see a firefly, it is emitting light. The wave mechanical model for an atom is analogous to the firefly because the electron in an atom is emitting light (electromagnetic radiation).	wave mechanical model	How is wave mechanical model analogous to firefly in a dark room?
Wave mechanical model is analogous to firefly in a dark room because it uses the wave-particle duality to explain the nature of light. Just like how fireflies emit light in a dark room, light is also explained as being made up of particles (photons) and waves.	wave mechanical model	How is wave mechanical model analogous to firefly in a dark room?
An electroencephalogram is used to measure and record the electrical activity of the brain. This test is similar to listening to a game because it can give you information about what is happening in real time.	electroencephalogram	How is electroencephalogram analogous to listening to a game?
The analogy would be that an electroencephalogram is like listening to a game on the radio. Just as you can hear the announcer and players, you can also see the EEG waves representing their activity.	electroencephalogram	How is electroencephalogram analogous to listening to a game?
When you are listening to a game on the radio, you are hearing the electrical signals that are being sent from the broadcasting station to your radio. The same thing happens when you are looking at an EEG reading. You are seeing the electrical signals that are being sent from your brain to the machine.	electroencephalogram	How is electroencephalogram analogous to listening to a game?
Listening to a game on the radio is analogous to an electroencephalogram (EEG). Just as with an EEG, when you listen to a game on the radio you are able to hear what is happening without seeing it. This is because both use sound waves to transmit information.	electroencephalogram	How is electroencephalogram analogous to listening to a game?
When you listen to a game on the radio, you are listening to someone else's account of what is happening. You are not seeing the game yourself. An electroencephalogram is similar in that it is a recording of someone else's brain activity.	electroencephalogram	How is electroencephalogram analogous to listening to a game?
Dna replication is analogous to book printing in that they are both processes of copying information. With DNA replication, the information is copied from one molecule of DNA to another. With book printing, the information is copied from a manuscript to pages in a printed book.	dna replication	How is dna replication analogous to book printing?
Replication of DNA is analogous to photocopying in that it produces an exact copy of the original.	dna replication	How is dna replication analogous to photocopier machine?
A photocopier machine is a device that makes copies of documents by projecting an image of the document onto a photoconductor and then using a laser to scan the image and produce electrical signals. These signals are converted into digital information, which is used to create a duplicate of the original document. Dna replication works in a similar way. The dna molecule is like the document, and the proteins responsible for replication are like the photocopier machine. When ultraviolet light hits the dna molecule, it causes thymine dimers to form. These dimers can be thought of as errors or black spots on the document. The proteins involved in replication recognize these dimers and use them as instructions to create new dna molecules that are identical to the original molecule.	dna replication	How is dna replication analogous to photocopier machine?
A photocopier machine copies an image by projecting light onto a surface and then reproducing the image using a chemical process. DNA replication is analogous to a photocopier machine because it also involves the use of light (in the form of ultraviolet radiation) and a chemical process (the synthesis of new DNA strands).	dna replication	How is dna replication analogous to photocopier machine?
Dna replication is analogous to photocopier machine because they are both copying mechanisms. The dna replicates itself by splitting in two, and the photocopier makes a copy of an image by projecting light onto it and then recreating the image using ink.	dna replication	How is dna replication analogous to photocopier machine?
Rna transcription is analogous to language translation in that they are both processes by which information is conveyed from one entity to another. In the case of rna transcription, genetic information is transcribed from dna into rna molecules, while in the case of language translation, a text is translated from one language into another. Both processes involve the use of a code or set of rules in order to convey the message accurately.	rna transcription	How is rna transcription analogous to language translation?
Rna transcription is analogous to language translation in that they are both processes by which information is transferred from one form to another. In transcription, rna is synthesized based on the sequence of dna codons. In translation, protein synthesis occurs based on the sequence of rna codons.	rna transcription	How is rna transcription analogous to language translation?
RNA transcription is analogous to language translation in that they are both processes by which information is conveyed from one form to another. In the case of RNA transcription, genetic information is converted into a molecule called RNA; while in the case of language translation, a text is converted into another language.	rna transcription	How is rna transcription analogous to language translation?
RNA transcription is analogous to language translation in that they are both processes that involve the use of a code. RNA transcription uses the genetic code to create a molecule of messenger RNA, while language translation uses a dictionary to convert written words into another language.	rna transcription	How is rna transcription analogous to language translation?
In both cases, there is a message that needs to be conveyed. In the case of rna transcription, the message is encoded in the sequence of nucleotides in the dna molecule. This message is then "read" and translated into a specific sequence of amino acids in the protein molecule.	rna transcription	How is rna transcription analogous to language translation?
Just as a translator must understand both the source and target languages in order to accurately translate between them, so too does a ribosome need to understand the language of DNA (the genetic code) and the language of proteins (amino acid sequence) in order to synthesize proteins.	protein translation	How is protein translation analogous to language translation?
Protein translation is analogous to language translation in that they are both processes that involve the conversion of one form of information into another. Protein translation is the process by which proteins are synthesized from mRNA, and language translation is the process by which words are converted into another language.	protein translation	How is protein translation analogous to language translation?
Protein translation is analogous to language translation because they are both processes that involve the conversion of one type of information into another.	protein translation	How is protein translation analogous to language translation?
The analogy between protein translation and language translation is that they are both processes of converting some sort of code into a useful product. In the case of protein translation, the code is an mRNA molecule, and the product is a protein. In the case of language translation, the code is a set of written symbols, and the product is an interpretation of those symbols in another language.	protein translation	How is protein translation analogous to language translation?
Protein translation is analogous to language translation in that they are both processes by which a message is conveyed from one entity to another. In protein translation, the sequence of codons on a mRNA molecule directs the synthesis of a specific protein chain. In language translation, words on a page are converted into another language according to a set of rules.	protein translation	How is protein translation analogous to language translation?
Just like cities, ecosystems are composed of many different parts that all work together to create a functioning system. Ecosystems include everything from the plants and animals that live there, to the climate and physical features of the area. Like cities, each ecosystem is unique and has its own set of rules that governs how it works.	ecosystem	How is ecosystem analogous to cities?
Cities are analogous to ecosystems because they are both places where humans and other species live together in close proximity. Like cities, ecosystems contain a variety of different types of species that interact with one another in complex ways.	ecosystem	How is ecosystem analogous to cities?
A city can be thought of as an ecosystem, with humans and their activities (building, farming, etc.) being one part of it. Other organisms in a city include rats, cockroaches, pigeons, trees, and flowers. Just like in a natural ecosystem, the different parts of a city interact with each other to create a complex web of relationships.	ecosystem	How is ecosystem analogous to cities?
Ecosystems are similar to cities in that they are both composed of many interconnected parts. Ecosystems include living things (plants and animals), their physical environment (such as rocks and soil), and the interactions between them. Just like in a city, the different parts of an ecosystem interact with each other to create a complex system.	ecosystem	How is ecosystem analogous to cities?
Ecosystems are analogous to cities in that they are both composed of interconnected parts that work together to achieve a common goal. In the case of an ecosystem, the goal is to sustain life; while in the case of a city, the goal is to provide a place for people to live and work.	ecosystem	How is ecosystem analogous to cities?
Propagation of an action potential down a neuron is analogous to falling dominoes in that the propagation of one event can trigger another. In both cases, there is a sequence of events that leads to a final outcome.	propagation of an action potential down a neuron	How is propagation of an action potential down a neuron analogous to falling dominoes?
Propagation of an action potential down a neuron is analogous to falling dominoes because when the first domino falls, it knocks over the next one, which then knocks over the next one, and so on. This analogy can be used to help explain how an action potential travels down a neuron.	propagation of an action potential down a neuron	How is propagation of an action potential down a neuron analogous to falling dominoes?
The analogy between action potential propagation and falling dominoes is that when the first domino falls, it knocks over the next one, which in turn knocks over the next one, and so on. In a similar way, when an action potential propagates down a neuron, it causes voltage-gated ion channels to open in the membrane of the next neuron, which allows ions to flow into or out of the neuron. This then causes the membrane potential of the next neuron to change, which can propagate the action potential further along the chain of neurons.	propagation of an action potential down a neuron	How is propagation of an action potential down a neuron analogous to falling dominoes?
One analogy for the propagation of an action potential down a neuron is that it is like falling dominoes. Each domino represents a section of the axon, and when the first one falls, it knocks over the next one, which then knocks over the next one, and so on. This analogy helps to illustrate how an action potential can travel quickly down a long axon.	propagation of an action potential down a neuron	How is propagation of an action potential down a neuron analogous to falling dominoes?
A neuron is like a long row of dominoes. When the first domino falls, it knocks over the next one, and so on. This is how an action potential travels down a neuron.	propagation of an action potential down a neuron	How is propagation of an action potential down a neuron analogous to falling dominoes?
The frog's breathing mechanism is analogous to blowing up a balloon. The frog's lungs fill with air as it breathes in and the air is forced out of the lungs as the frog exhales. This process is similar to how a balloon fills with air when you blow into it and deflates when you let go of the balloon.	breathing mechanism of frogs	How is breathing mechanism of frogs analogous to blowing of the balloon?
In both cases, the object is using air to create a space. In the case of the balloon, the air is being blown into the balloon. This creates a space inside of the balloon. In the case of frog breathing, the frog is sucking in air. This creates a space in its lungs.	breathing mechanism of frogs	How is breathing mechanism of frogs analogous to blowing of the balloon?
The frog's breathing mechanism is analogous to the blowing of a balloon in that they are both mechanisms used to create air flow.	breathing mechanism of frogs	How is breathing mechanism of frogs analogous to blowing of the balloon?
The frog's breathing mechanism is analogous to the blowing of the balloon in that they are both mechanisms for getting air into and out of something.	breathing mechanism of frogs	How is breathing mechanism of frogs analogous to blowing of the balloon?
Blowing up a balloon is similar to how frogs breathe. When you blow up a balloon, you are forcing air into the balloon. This causes the balloon to inflate and get bigger. Frogs also inflate their lungs by breathing in air.	breathing mechanism of frogs	How is breathing mechanism of frogs analogous to blowing of the balloon?
Layered architecture is analogous to communication with translators in that it provides a way for different parts of the system to communicate without having to understand each other's code. This allows different parts of the system to be developed and updated separately, which makes the system more flexible and reliable.	layered architecture	How is layered architecture analogous to communication with translators?
Just as translators mediate communication between different languages, layers in a layered architecture mediate communication between different parts of the system. In both cases, communication is more efficient and accurate when it flows through a translator or layer.	layered architecture	How is layered architecture analogous to communication with translators?
A layered architecture is analogous to communication with translators because it allows different parts of the system to communicate with each other without having to understand the complexities of how each part works. By using a translator, each part can send and receive information in a way that is most meaningful for them, while still being able to interact seamlessly with the rest of the system.	layered architecture	How is layered architecture analogous to communication with translators?
If a business wants to communicate with people in other parts of the world, it might use a translator to help convert its words into another language. In a similar way, layered architecture helps different parts of an application communicate with each other. The layer closest to the user (such as the presentation layer) converts information into a format that can be understood by the next lowest layer (such as the business logic layer), and so on. This allows developers to create applications using smaller pieces that can be easily reused and modified.	layered architecture	How is layered architecture analogous to communication with translators?
Just as communication with translators allows for people who speak different languages to effectively communicate with one another, layered architecture allows different parts of a software system to communicate effectively with one another. The use of layers in architecture provides a way for the various parts of a system to be organized and separated, making it easier for them to work together. Each layer can act as a translator between the layers above and below it, allowing information to be passed smoothly between them.	layered architecture	How is layered architecture analogous to communication with translators?
In both chocolate distribution and reactant limiting, there is a finite amount of product that can be created given the available resources. In chocolate distribution, there are only so many pieces of candy to go around, and in reactant limitation, there is only a certain amount of each reactant that can be used to produce the desired product. In each case, not all participants will get what they want.	limiting reactant and excess reactant	How is limiting reactant and excess reactant analogous to chocolate distribution?
A limiting reactant is like a chocolate bar that is being distributed to a group of people. If there are more people than chocolate bars, then not everyone will get one and some will end up with none. An excess reactant is like an extra chocolate bar that is being distributed to the same group of people. If there are more chocolate bars than people, then everyone will get one and there will be no leftovers.	limiting reactant and excess reactant	How is limiting reactant and excess reactant analogous to chocolate distribution?
A limiting reactant is like a chocolate bar that is being shared between a number of people. The more people there are, the less each person gets. An excess reactant is like a chocolate bar that has been left out and is freely available to all.	limiting reactant and excess reactant	How is limiting reactant and excess reactant analogous to chocolate distribution?
Chocolate distribution is similar to limiting reactant and excess reactant because it is all about how much of a substance is available. In the case of chocolate, there are not enough pieces for everyone so those who get there first will get more while those who come later will get less. It's the same with limiting reactant and excess reactant; if there isn't enough of a particular chemical to go around, then the reaction won't happen as quickly (or at all) and some substances will be in short supply.	limiting reactant and excess reactant	How is limiting reactant and excess reactant analogous to chocolate distribution?
Limiting reactant is analogous to chocolate distribution because when there is a limiting reactant, the reaction will stop once that reactant is gone. This means that not all of the chocolate will be used and some will remain in its original form. Excess reactant is also analogous to chocolate distribution because when there is an excess of a reactant, the reaction will continue until all of the extra material has been used up. This means that more chocolate than necessary will be used and less chocolate will remain in its original form.	limiting reactant and excess reactant	How is limiting reactant and excess reactant analogous to chocolate distribution?
In a working office, there are many different people with different jobs who work together to achieve a common goal. Similarly, in a eukaryotic cell, there are many different parts (organselles) that work together to carry out the cell's functions.	eukaryotic cell	How is eukaryotic cell analogous to working office?
A eukaryotic cell is analogous to a working office in that they are both organized and have specific jobs that need to be done in order for the larger entity to function. The cells within our bodies are like the employees within an office, each with their own task that contributes to the overall goal.	eukaryotic cell	How is eukaryotic cell analogous to working office?
A eukaryotic cell is analogous to a working office because it has many different parts that all work together to create a functioning unit. Just like an office has workers who perform different tasks, a eukaryotic cell has organelles that carry out specific functions.	eukaryotic cell	How is eukaryotic cell analogous to working office?
A eukaryotic cell can be seen as analogous to a working office in several ways. Both contain many small parts that work together to achieve a common goal. The cells nucleus contains the genetic information necessary for the cell to function, just as a company's headquarters would contain the vital information needed for the organization to operate. Eukaryotic cells also have specialized areas called organelles that carry out specific tasks, similar to how an office has individual employees who are responsible for specific functions. Finally, both offices and cells require energy in order to operate; in a cell this comes from nutrients absorbed by its plasma membrane, while an office gets its power from electricity supplied by utilities companies.	eukaryotic cell	How is eukaryotic cell analogous to working office?
A eukaryotic cell is analogous to a working office in that both have multiple parts that work together to achieve a common goal. The nucleus is like the boss, giving orders to the other parts of the cell. The cytoplasm is like the workers, carrying out the instructions from the nucleus.	eukaryotic cell	How is eukaryotic cell analogous to working office?
A prokaryotic cell is analogous to a self-started business because it can replicate without the help of another cell. Like a self-starter business, a prokaryotic cell has all the tools it needs to get going and doesn't require outside input to grow and thrive.	prokaryotic cell	How is prokaryotic cell analogous to self started business?
A prokaryotic cell is a self-sufficient, autonomous unit much like a small business. It has all the necessary components to survive and grow without help from other cells. Prokaryotes can also reproduce on their own to create more of their kind.	prokaryotic cell	How is prokaryotic cell analogous to self started business?
A prokaryotic cell is analogous to a self-started business in that it is autonomous and has the ability to replicate without outside assistance.	prokaryotic cell	How is prokaryotic cell analogous to self started business?
A prokaryotic cell is analogous to a self-started business in that it is an entity that is independent and reliant on its own resources.	prokaryotic cell	How is prokaryotic cell analogous to self started business?
A prokaryotic cell is analogous to a self-started business in that it is an autonomous entity that initiates and sustains its own activity. Like a business, a prokaryotic cell must generate its own energy and nutrients, carry out metabolic processes, and respond to environmental challenges.	prokaryotic cell	How is prokaryotic cell analogous to self started business?
An operating system kernel can be thought of as analogous to a library. Just as a library provides books for people to read, an operating system kernel provides programs for people to use.	operating systems kernel	How is operating systems kernel analogous to college library?
The kernel of an operating system is analogous to the library at a college. The library contains all of the books that are required for classes, and the kernel contains all of the code that is required for running an operating system.	operating systems kernel	How is operating systems kernel analogous to college library?
The kernel is the heart of an operating system, analogous to a college library's collection of books. The kernel provides basic services for all other parts of the operating system, analogous to the librarians who manage and organize the books in a library. Just as different sections of a library are specialized (e.g., biochemistry, history), so too are different parts of an operating system's kernel (e.g., process management, file systems).	operating systems kernel	How is operating systems kernel analogous to college library?
The operating system kernel is analogous to the college library because it stores all of the information that the computer needs to run. The kernel manages memory, processes, and files, just like a librarian manages books in a library.	operating systems kernel	How is operating systems kernel analogous to college library?
An operating system kernel is analogous to a college library in that they are both essential parts of the system. The kernel is the core of the operating system, while the library is the core of the academic institution.	operating systems kernel	How is operating systems kernel analogous to college library?
A limiting reactant is analogous to an engine because it is the component of a chemical reaction that limits the amount of product that can be formed. Just as an engine needs fuel in order to generate power, a limiting reactant needs to be present in order for a reaction to occur.	limiting reactant	How is limiting reactant analogous to engine?
A cup of coffee granules is analogous to a limiting reactant because it is the ingredient that is in shortest supply and will limit the amount of coffee that can be made.	limiting reactant	How is limiting reactant analogous to a cup of coffee granules?
A limiting reactant is like an engine because it sets the maximum speed or output that can be achieved. In a chemical reaction, the amount of product that can be formed is limited by the amount of limiting reactant present.	limiting reactant	How is limiting reactant analogous to engine?
In an engine, a fuel (the limiting reactant) is burned with oxygen from the air to produce mechanical work. The amount of work that can be produced is limited by the amount of fuel that is available.	limiting reactant	How is limiting reactant analogous to engine?
A limiting reactant is analogous to an engine because it limits the overall reaction. Just as an engine needs fuel in order to run, a limiting reactant controls how much product can be formed by setting the upper limit on the amount of chemical reaction that can occur.	limiting reactant	How is limiting reactant analogous to engine?
Zipper zip is a type of fastener that joins two pieces of fabric together. It does this by using teeth on one side of the fabric to clasp onto teeth on the other side, similar to how a zipper works. Helicase is analogous to zipper zip because it helps join two DNA strands together. Like a zipper, it uses teeth (or in this case, bases) to clasp onto the other strand and hold them together.	helicase	How is helicase analogous to zipper zip?
Helicase is analogous to zipper zip because they are both used to join two pieces of fabric together.	helicase	How is helicase analogous to zipper zip?
Zipper zip is a type of fastener that is used to join two pieces of fabric together. It consists of two rows of teeth that interlock when the zipper is pulled up or down. Helicase is analogous to zipper zip because it helps to join two DNA strands together.	helicase	How is helicase analogous to zipper zip?
Helicase is analogous to a zipper zip because they are both used to join two pieces of fabric together. Helicase helps DNA strands come together during replication, while the zipper zip joins two pieces of fabric together.	helicase	How is helicase analogous to zipper zip?
A zipper is a clothing item with a series of small, interconnected metal or plastic teeth along one edge. When the two edges are brought together, the teeth interlock and the fabric is secured. Helixes are also made up of small, interconnected pieces that work together to perform a function. In both cases, if one piece is missing or damaged, the whole system falls apart.	helicase	How is helicase analogous to zipper zip?
The analogy would be that the DNA replication binding proteins are like hands holding open two strips of magnets. The magnets will stay together as long as the hands are holding them open.	dna replication binding proteins	How is dna replication binding proteins analogous to hands holding open two strips of magnet?
Binding proteins are analogous to hands holding open two strips of magnet because they hold the DNA strands apart so that replication can occur.	dna replication binding proteins	How is dna replication binding proteins analogous to hands holding open two strips of magnet?
DNA replication binding proteins are analogous to hands holding open two strips of magnet because they hold the DNA strands apart so that the replication process can occur.	dna replication binding proteins	How is dna replication binding proteins analogous to hands holding open two strips of magnet?
DNA replication binding proteins are analogous to hands holding open two strips of magnet because they hold the DNA strands apart so that the enzymes can replicate them.	dna replication binding proteins	How is dna replication binding proteins analogous to hands holding open two strips of magnet?
Binding proteins are analogous to hands holding open two strips of magnets because they hold the DNA strands apart so that replication can occur.	dna replication binding proteins	How is dna replication binding proteins analogous to hands holding open two strips of magnet?
A ligase is analogous to a sewing machine in that they are both used to join two pieces of fabric together.	ligase	How is ligase analogous to sewing machine?
A ligase is a type of enzyme that helps to sew together pieces of DNA. It does this by linking two nucleotides together, forming what is called a phosphodiester bond. This same process occurs in a sewing machine when it stitches fabric together.	ligase	How is ligase analogous to sewing machine?
Ligase is the enzyme that joins two DNA fragments together. It is analogous to a sewing machine because it stitches two pieces of fabric (DNA) together, just as a sewing machine stitches two pieces of fabric together.	ligase	How is ligase analogous to sewing machine?
A ligase is an enzyme that helps to join two DNA strands together. It is analogous to a sewing machine because it uses a needle (the enzyme) to sew the two pieces of fabric (DNA strands) together.	ligase	How is ligase analogous to sewing machine?
A ligase is an enzyme that helps stitch pieces of DNA together. It works a bit like a sewing machine, by stitching two pieces of thread (DNA) together.	ligase	How is ligase analogous to sewing machine?
A process control block (PCB) is a data structure in a Unix-like operating system that stores information about one active process. Analogous to an inode, the PCB contains pointers to the executable file, its associated data files, and maps memory addresses to their corresponding offsets within those files.	process control block	How is process control block analogous to inode?
The process control block (PCB) is analogous to the inode. Just as the inode contains information about a file, the PCB stores information about a process. This includes its PID, state, and memory address space.	process control block	How is process control block analogous to inode?
A process control block (PCB) is analogous to an inode. They are both data structures that contain information about a particular process or file, respectively.	process control block	How is process control block analogous to inode?
A process control block (PCB) is a data structure in Unix-like operating systems that stores information about a running process, including the process's PID, CPU time usage, memory usage, controlling terminal, and resource utilization. Analogously, an inode is a data structure in Unix-like operating systems that stores information about a file or directory, including its location on the filesystem tree and its owning user and group.	process control block	How is process control block analogous to inode?
A process control block (PCB) is analogous to an inode. They are both data structures that store information about a file or process.	process control block	How is process control block analogous to inode?
When you encode a message, you are putting it into a specific format so that it can be communicated. This is similar to how when you speak, you put your thoughts into words and use a specific language so that others can understand.	message encoding	How is message encoding analogous to speaking?
When you speak, your voice is encoded into sound waves that travel through the air. When someone else hears these sound waves, their brain decodes them back into the original message. This process is similar to how computers encode and decode messages.	message encoding	How is message encoding analogous to speaking?
Message encoding is a way of representing information in a format that can be transmitted between two devices. This is similar to speaking, where the speaker needs to encode the message in a way that can be understood by the listener.	message encoding	How is message encoding analogous to speaking?
Message encoding is analogous to speaking in that it takes an input (a message) and produces an output (an encoded message).	message encoding	How is message encoding analogous to speaking?
Message encoding is analogous to speaking in that they are both methods of communicating information. Message encoding takes text or other data and encodes it into a format that can be transmitted over a network or stored. This format may be binary, ASCII, Unicode, or another representation. Speaking involves conveying information verbally using sounds that are interpreted by the listener.	message encoding	How is message encoding analogous to speaking?
The interaction between drugs and receptor sites is analogous to the foot fitting in a footprint. The drug fits into the receptor site just like the foot fits into the impression of a foot. This analogy is helpful in understanding how drugs work and how they can be matched with specific receptors to produce a desired effect.	interaction between drugs and receptor sites	How is interaction between drugs and receptor sites analogous to foot fitting in footprint?
Just as a key is specifically shaped to fit into a lock, a drug can be specifically shaped to fit into a receptor site on a cell. When the drug binds to the receptor site, it initiates a response in the cell. This analogy is helpful in understanding how drugs work and why they sometimes produce unwanted side effects.	interaction between drugs and receptor sites	How is interaction between drugs and receptor sites analogous to lock and key?
Interaction between drugs and receptor sites is analogous to foot fitting in footprint because it is a way of matching up the correct objects. In this analogy, the drugs are the feet and the receptor sites are the footprints.	interaction between drugs and receptor sites	How is interaction between drugs and receptor sites analogous to foot fitting in footprint?
The interaction between drugs and receptor sites is analogous to foot fitting in footprint because when a drug attaches to a receptor site, it conforms to the shape of that site much like a foot fits into the impression made by a shoe. This analogy helps us to understand how drugs can interact with specific receptors to produce specific effects.	interaction between drugs and receptor sites	How is interaction between drugs and receptor sites analogous to foot fitting in footprint?
Receptor sites are analogous to locks, and drugs are analogous to keys. When a drug binds to a receptor site, it is like putting a key in a lock. This causes the receptor site to change shape, which activates the protein inside the cell that it is attached to.	interaction between drugs and receptor sites	How is interaction between drugs and receptor sites analogous to lock and key?
A monitor is analogous to a human face in that they are both used for displaying information.	monitor	How is monitor analogous to human face?
A monitor is analogous to a human face in that they are both devices used for displaying information.	monitor	How is monitor analogous to human face?
A monitor is analogous to a human face because they are both two-dimensional surfaces that people look at in order to see what is happening.	monitor	How is monitor analogous to human face?
A monitor is similar to a human face in that it is used for communication. A person looks at a monitor to see what is on the screen.	monitor	How is monitor analogous to human face?
A monitor is analogous to a human face in that they are both two dimensional surfaces that display information.	monitor	How is monitor analogous to human face?
The CPU is analogous to the brain in that they are both responsible for performing complex tasks. The CPU is responsible for executing instructions and handling data, while the brain is responsible for controlling movement, thinking, and feeling.	cpu	How is cpu analogous to brain?
The CPU is analogous to the brain in that they are both responsible for performing tasks. The CPU handles all of the calculations for a computer, while the brain controls everything that happens in the body.	cpu	How is cpu analogous to brain?
The CPU (central processing unit) is analogous to the brain because it is responsible for controlling and coordinating all of the activities within the computer. It does this by executing programs that are stored in memory, just as the brain executes commands from the nervous system.	cpu	How is cpu analogous to brain?
Just as the CPU is responsible for tasks such as calculations and memory management in a computer, the brain is responsible for similar tasks in humans. The CPU is analogous to the brain because they are both responsible for handling important processes.	cpu	How is cpu analogous to brain?
One way to think about the relationship between a computer's CPU and a human brain is that the CPU is like the brain's central processing unit, while the other components of the computer are like the peripheral nervous system. The CPU performs most of the computation in a computer system, while other parts handle input and output. In a similar way, information processing in the brain takes place mainly in the cortex, with some limited processing occurring in subcortical regions.	cpu	How is cpu analogous to brain?
A motherboard is analogous to a skeleton because they are both structures that hold other components in place.	motherboard	How is motherboard analogous to skeleton?
A motherboard is analogous to a skeleton in that both are essential for the support and function of the organism. A skeleton provides a frame for an organism, while a motherboard provides a frame for a computer system. Additionally, both can be upgraded or replaced as needed.	motherboard	How is motherboard analogous to skeleton?
A motherboard can be thought of as the skeleton of a computer. It is the main component that everything else plugs into, and it provides the framework on which all other components are mounted.	motherboard	How is motherboard analogous to skeleton?
A motherboard is analogous to a skeleton in that they are both the foundation of something larger. A motherboard holds all the important components of a computer, much like a skeleton holds all the muscles and organs of a body.	motherboard	How is motherboard analogous to skeleton?
A motherboard is analogous to a skeleton in that they are both frameworks that hold other components in place.	motherboard	How is motherboard analogous to skeleton?
Ram is analogous to pre-frontal lobe in that they are both responsible for executive functions. This includes planning, organizing, strategizing, and inhibiting inappropriate responses.	ram	How is ram analogous to pre-frontal lobe?
Ram is analogous to pre-frontal lobe in that they are both responsible for information processing. Ram is responsible for the interpretation and analysis of sensory input, while pre-frontal lobe is responsible for higher-level cognitive functions such as decision making, planning, and problem solving.	ram	How is ram analogous to pre-frontal lobe?
The analogy between ram and prefrontal lobe is that they are both important for cognitive function. The ram is known for its intelligence and ability to problem-solve, and the prefrontal cortex is responsible for many of the same functions, such as executive control, decision-making, and working memory.	ram	How is ram analogous to pre-frontal lobe?
The analogy between ram and pre-frontal lobe is that they are both used for decision making. The ram makes decisions about where to go, and the pre-frontal lobe makes decisions about what actions to take.	ram	How is ram analogous to pre-frontal lobe?
Ram is analogous to pre-frontal lobe because it helps with decision making, focus and impulse control.	ram	How is ram analogous to pre-frontal lobe?
A power supply unit is analogous to energy in that they are both necessary components of a system. A PSU provides power to a system, while energy is necessary for a system to function.	power supply unit	How is power supply unit analogous to energy?
A power supply unit (PSU) is an electronic device that supplies electrical power to an attached computer system. The PSU converts incoming AC power from the wall socket to the DC voltages required by the computer's internal components. In analogy, a PSU can be thought of as an energy converter, taking in one form of energy and converting it into another form needed by the system.	power supply unit	How is power supply unit analogous to energy?
A power supply unit is analogous to energy in that they are both necessary components for a device to function.	power supply unit	How is power supply unit analogous to energy?
Power supply units (PSUs) are analogous to energy because they supply a device with the power it needs in order to function. Just as an energy source like a battery or electrical outlet supplies power to a device, so too does a PSU. This allows the device to run its various components, including displays, processors and fans.	power supply unit	How is power supply unit analogous to energy?
A power supply unit is analogous to energy because it supplies a device with the ability to use electricity.	power supply unit	How is power supply unit analogous to energy?
Just as our hands can be used for a variety of tasks, from brushing our teeth to cooking dinner, a keyboard can be used for a variety of purposes. We might use our hands to type out an email on the computer, or we might use them to control the cursor on the screen.	keyboard	How is keyboard analogous to hands?
The keyboard is analogous to hands because it is what we use to input information into the computer.	keyboard	How is keyboard analogous to hands?
The keyboard is analogous to the hands in that they are both tools used for input. The keyboard is used to type information into a computer, while the hands are used to input information into a person's mind.	keyboard	How is keyboard analogous to hands?
Just as our hands can be used to type on a keyboard, they can also be used to play an instrument.	keyboard	How is keyboard analogous to hands?
Just as our hands can manipulate objects in our environment, a keyboard allows us to type letters and symbols that create words and sentences.	keyboard	How is keyboard analogous to hands?
A mouse is analogous to the senses because it can be used to interact with the environment.	mouse	How is mouse analogous to senses?
A mouse is analogous to the senses because it is small and fast, and can be used to explore an area.	mouse	How is mouse analogous to senses?
A mouse is analogous to the senses because it can be used to explore and navigate an environment.	mouse	How is mouse analogous to senses?
A mouse is analogous to senses because it is a small animal that can be used for research purposes to study the effects of different drugs or stimuli on the nervous system.	mouse	How is mouse analogous to senses?
Mouse is analogous to senses because a mouse can be used to explore the area around it. Similarly, our senses allow us to explore and learn about our environment.	mouse	How is mouse analogous to senses?
The audio card is analogous to the ear in that they are both input and output devices. The audio card inputs sound waves and outputs them as electronic signals which can be played back through speakers or headphones. The ear inputs sound waves and outputs them as electrical nerve impulses which are sent to the brain to be interpreted as sound.	audio card	How is audio card analogous to ear?
An audio card is analogous to the ear in that it is a listening device. It allows you to listen to sound and music on your computer.	audio card	How is audio card analogous to ear?
A computer's audio card is analogous to a person's ear in that they are both devices used for listening.	audio card	How is audio card analogous to ear?
Just as your ears allow you to hear the world around you, a computer's audio card allows it to produce and/or play back sound.	audio card	How is audio card analogous to ear?
An audio card is generally analogous to the human ear in that they are both used for listening to sounds.	audio card	How is audio card analogous to ear?
A video card is analogous to the eye in that they are both input devices.	video card	How is video card analogous to eye?
A video card is analogous to an eye in that it is a device used to view digital images.	video card	How is video card analogous to eye?
A video card is analogous to the eye in that they are both input devices.	video card	How is video card analogous to eye?
A video card is analogous to the eye in that they are both input devices used to view information.	video card	How is video card analogous to eye?
A video card is analogous to the eye in that they are both devices used to view digital media.	video card	How is video card analogous to eye?
Coral's age calculation is analogous to tree's age calculation because they are both estimating the amount of time that has passed since an event occurred. Coral does this by measuring the growth rings on its skeleton, while trees do this by counting the number of annual growth rings.	tree's age calculation	How is tree's age calculation analogous to coral's age calculation?
The tree's age calculation is analogous to coral's age calculation because they are both estimating the amount of time that has passed since an event occurred. In the case of a tree, this would be the time since it germinated from a seed. For coral, this would be the time since it was first deposited as part of a colony.	tree's age calculation	How is tree's age calculation analogous to coral's age calculation?
Coral's age calculation is analogous to tree's age calculation in that they are both estimating the amount of time that has passed since an event. Coral does this by measuring the growth of their coral skeleton, while trees do it by counting the number of rings in their trunk.	tree's age calculation	How is tree's age calculation analogous to coral's age calculation?
A tree's age calculation is analogous to coral's age calculation in that they are both estimates of how long something has been alive. Coral uses a growth rate estimate to calculate its age, while trees use rings (or other methods) to count the years since the tree was planted or started growing.	tree's age calculation	How is tree's age calculation analogous to coral's age calculation?
A tree's age is calculated by counting the number of rings in a cross-section of the trunk. A coral's age is calculated by counting the number of growth layers in a cross-section of the skeleton.	tree's age calculation	How is tree's age calculation analogous to coral's age calculation?
The analogy between glycolysis and a roller coaster is that they are both processes in which energy is released. In the case of glycolysis, this energy is used to power cellular processes. In the case of a roller coaster, this energy is used to create motion.	glycolysis	How is glycolysis analogous to roller coaster?
Glycolysis is analogous to a roller coaster because it is an energy-providing process that involves a lot of ups and downs.	glycolysis	How is glycolysis analogous to roller coaster?
Both glycolysis and a roller coaster are processes that involve energy. In the case of glycolysis, this energy is harnessed from glucose molecules to create adenosine triphosphate (ATP). With a roller coaster, this energy is harnessed from potential and kinetic energy in order to move riders up and down hills.	glycolysis	How is glycolysis analogous to roller coaster?
The first analogy that comes to mind is that glycolysis is like a roller coaster ride. It starts out slowly and then builds up speed until it reaches a peak. The ride then slows down again before ending. Another analogy could be that glycolysis is like climbing a hill. It takes time to get to the top, but once you reach the summit, the descent is fast and easy.	glycolysis	How is glycolysis analogous to roller coaster?
A roller coaster analogy for glycolysis is that it is like riding a roller coaster. The ride starts out slowly, but then it quickly speeds up and reaches the top of the track. The ride then comes back down to the bottom and ends with a slow stop. This is similar to how glycolysis works because it starts out slowly by using only one glucose molecule, but then it quickly uses up all of the glucose molecules and ends with a slow stop.	glycolysis	How is glycolysis analogous to roller coaster?
In both cases, there is a transfer of energy from one object to another. In ball striking a plate, the energy from the ball is transferred to the plate, causing it to vibrate. In anti-stokes scattering, the energy from the light beam is transferred to the atom, causing it to vibrate.	anti-stokes scattering	How is anti-stokes scattering analogous to ball striking a plate?
When a ball is struck against a plate, it creates vibrations that spread out in all directions. These vibrations are analogous to the light waves scattered by an object.	anti-stokes scattering	How is anti-stokes scattering analogous to ball striking a plate?
The scattering of light by an object is analogous to the scattering of a ball by a plate. In both cases, some energy is transferred from the projectile (ball or light) to the target (plate or material).	anti-stokes scattering	How is anti-stokes scattering analogous to ball striking a plate?
Ball striking a plate is analogous to anti-stokes scattering because it is both an interaction between two objects. In ball striking a plate, the ball hits the plate and bounces off. This interaction creates forces that cause the ball to move in a new direction. In anti-stokes scattering, light hits an object and scatters in all directions. This interaction also creates forces that cause light to move in new directions.	anti-stokes scattering	How is anti-stokes scattering analogous to ball striking a plate?
When a ball is thrown at a plate, the ball rebounds off of the plate. This is analogous to anti-stokes scattering, where light rebounces off of an object.	anti-stokes scattering	How is anti-stokes scattering analogous to ball striking a plate?
When a ball is hit against a plate, it scatters in all directions. This is similar to the way light scatters when it hits particles in the atmosphere.	stokes scattering	How is stokes scattering analogous to ball striking a plate?
When a ball is thrown at a plate, the ball rebounds off of the plate in a different direction. This occurs because when the ball hits the plate, it causes some of the energy from the ball to be transferred to the plate. This then causes the plate to vibrate and this vibration is what causes the rebound.Stokes scattering is very similar to this. When light hits an object, some of its energy is transferred to the object. This then causes the object to vibrate and this vibration is what scatters light in all directions.	stokes scattering	How is stokes scattering analogous to ball striking a plate?
In both cases, a force is applied to a surface. In stokes scattering, the force is from a light beam hitting a particle and in ball striking a plate, the force is from a ball hitting a plate.	stokes scattering	How is stokes scattering analogous to ball striking a plate?
Stokes scattering is analogous to ball striking a plate in that they are both examples of elastic scattering. In both cases, the objects involved exchange energy with each other after colliding.	stokes scattering	How is stokes scattering analogous to ball striking a plate?
In both situations, a projectile is interacting with a surface. In stokes scattering, the projectile is a light ray and the surface is an obstacle. In ball striking a plate, the projectile is a ball and the surface is a flat plane. Both interactions cause some of the energy of the projectile to be dissipated as it interacts with the surface.	stokes scattering	How is stokes scattering analogous to ball striking a plate?
The median lethal dose is analogous to balls and target in that it is a measure of how much a substance can harm an organism. In particular, the median lethal dose is the amount of a substance that is expected to kill half of the organisms exposed to it.	median lethal dose	How is median lethal dose analogous to balls and target?
The analogy is that the median lethal dose is the number of balls it takes to hit the target. The more balls you have, the higher your chances are of hitting the target.	median lethal dose	How is median lethal dose analogous to balls and target?
The analogy is that the balls are like the drugs and the target is like the person. The median lethal dose is the point at which there is a 50% chance of death.	median lethal dose	How is median lethal dose analogous to balls and target?
The median lethal dose is analogous to balls and target in that they are both ways of measuring a certain quantity. In this case, the quantity is the amount of a substance that is necessary to kill 50% of the population within a given time frame.	median lethal dose	How is median lethal dose analogous to balls and target?
The median lethal dose is analogous to balls and target because it is the dose of a substance that is expected to kill half of the people who are exposed to it.	median lethal dose	How is median lethal dose analogous to balls and target?
The universe is analogous to the surface of a balloon in that it is expanding. As the balloon expands, so does the universe.	universe	How is universe analogous to surface of a balloon?
The universe is analogous to the surface of a balloon in that it is constantly expanding.	universe	How is universe analogous to surface of a balloon?
The universe is analogous to the surface of a balloon in that it is expanding. The surface of a balloon expands when you blow air into it. Similarly, the universe expands when energy is injected into it.	universe	How is universe analogous to surface of a balloon?
A balloon is inflated with a gas, such as helium, hydrogen, or air. As the balloon expands, the surface becomes less curved and more stretched out. In the same way, the universe is expanding and becoming less curved.	universe	How is universe analogous to surface of a balloon?
The surface of a balloon is analogous to the universe because they are both three-dimensional.	universe	How is universe analogous to surface of a balloon?
The lock and key analogy is used to describe the mechanism of enzymes. The enzyme is like a key that fits into the lock of the substrate molecule and catalyzes its conversion into products.	enzyme mechanism	How is enzyme mechanism analogous to lock and key?
Enzyme mechanism is analogous to lock and key in that the enzyme is the lock and the substrate is the key. The lock will only open if the correct key is inserted into it.	enzyme mechanism	How is enzyme mechanism analogous to lock and key?
Enzyme mechanisms are analogous to lock and key because the enzyme is like a key that fits into the lock of the substrate molecule. The active site of the enzyme is specifically shaped to fit the substrate molecule, and when they bind together, chemical reactions take place that convert the substrate into a product.	enzyme mechanism	How is enzyme mechanism analogous to lock and key?
Enzyme mechanism is analogous to lock and key because the enzyme is like the key and the substrate is like the lock. The enzyme fits perfectly into the active site of the substrate to catalyze a reaction.	enzyme mechanism	How is enzyme mechanism analogous to lock and key?
Enzyme mechanisms are analogous to lock and key in that each enzyme has a specific region called the active site, which is complementary in shape to the substrate molecule. This analogy also extends to how enzymes work; just as a key can only fit into a certain lock, the correct substrate molecule can only bind to the active site of its respective enzyme.	enzyme mechanism	How is enzyme mechanism analogous to lock and key?
An ANOVA is an analysis of variance. It is used to determine if there are any statistically significant differences between the means of two or more groups. This analogy likens it to finding a signal in noise. Just as you can find a signal amid all the noise with enough effort, you can use an ANOVA to find any statistically significant differences between the means of groups.	anova	How is anova analogous to finding signal in the noise?
In anova, the signal is the mean of the treatment groups and the noise is the variation among the groups. The goal is to find a way to reduce the noise so that you can see the signal more clearly.	anova	How is anova analogous to finding signal in the noise?
Anova is analogous to finding signal in the noise because it is a technique used to identify significant differences between groups of data. It allows researchers to distinguish between variance that is due to chance and variance that is due to real differences between groups. This can be helpful in understanding how different factors influence the results of an experiment.	anova	How is anova analogous to finding signal in the noise?
An ANOVA is used to determine whether there is a statistically significant difference between the means of three or more groups. This procedure is analogous to finding a signal in noise because it allows us to determine which group (or groups) has a mean that differs from the others.	anova	How is anova analogous to finding signal in the noise?
The goal of anova is to identify statistically significant differences between the means of two or more groups. This is analogous to finding signal in noise because it allows you to extract information from a data set that is obscured by variation.	anova	How is anova analogous to finding signal in the noise?
A thermostat is analogous to the hypothalamus in that they are both responsible for regulating body temperature.	thermostat	How is thermostat analogous to hypothalamus?
The thermostat is analogous to the hypothalamus in that they are both responsible for regulating body temperature. The hypothalamus regulates body temperature by controlling how much heat the body produces and how much it loses. The thermostat does the same thing by turning on or off the heating or air conditioning depending on the desired temperature.	thermostat	How is thermostat analogous to hypothalamus?
The hypothalamus is analogous to a thermostat because it regulates the body's temperature.	thermostat	How is thermostat analogous to hypothalamus?
A thermostat is analogous to the hypothalamus in that they are both responsible for regulating body temperature.	thermostat	How is thermostat analogous to hypothalamus?
The hypothalamus is analogous to a thermostat because it controls the body's temperature.	thermostat	How is thermostat analogous to hypothalamus?
Chemical equilibrium is analogous to water level in dam and lake because when the chemical equilibrium is disturbed, it tries to return to its original state. The same thing happens with water levels in a dam and lake; if there is an imbalance, the water will try to correct itself.	chemical equilibrium	How is chemical equilibrium analogous to water level in dam and lake?
Water level in a dam and lake is analogous to chemical equilibrium because they are both systems that are trying to reach equilibrium. The water level in a dam is affected by the amount of water flowing into it and the amount of water flowing out of it. The water level in a lake is also affected by the amount of water flowing into it and the amount of water flowing out of it, but it is also affected by evaporation. Chemical equilibrium is similar because there are things entering and leaving the system that affect how equilibrium is reached.	chemical equilibrium	How is chemical equilibrium analogous to water level in dam and lake?
The water level in a dam and lake is analogous to chemical equilibrium because both are regulated by the balance of forces. In the case of the water level, gravity and other physical properties create a force that pulls the water down, while atmospheric pressure creates a force that pushes the water up. These two opposing forces create equilibrium, which is when the water levels stay constant. In a similar way, chemical equilibria are created by opposing forces such as enthalpy (heat) and entropy (disorder). When these two forces are balanced, the reaction reaches equilibrium.	chemical equilibrium	How is chemical equilibrium analogous to water level in dam and lake?
Chemical equilibrium is analogous to water level in dam and lake because it is a state of balance. In both cases, there is input and output that keeps things in check.	chemical equilibrium	How is chemical equilibrium analogous to water level in dam and lake?
Chemical equilibrium is analogous to water level in dam and lake because both the chemical equilibrium and water level depend on how much material is inputted or taken out of the system. With too much inflow, the water level rises, and with too much outflow, the water level falls. In a similar way, if more reactants are introduced into a chemical reaction than products are removed, then the concentration of reactants will increase until an equilibrium is reached where the rate of production equals the rate of consumption.	chemical equilibrium	How is chemical equilibrium analogous to water level in dam and lake?
Just-in-time is analogous to water and rocks because it is a process that helps things flow smoothly. Just-in-time allows for the timely delivery of goods and services, which is similar to how water flows over rocks and creates a smooth surface.	just-in-time	How is just-in-time analogous to water and rocks?
Just-in-time is analogous to water and rocks because it is a process that helps things run smoothly. Just-in-time is like the water, providing the resources needed for production to take place. The rocks are the raw materials used in production.	just-in-time	How is just-in-time analogous to water and rocks?
Just-in-time is analogous to water and rocks because it is a process that helps things run more smoothly. Just-in-time helps organizations be efficient by getting the right materials at the right time. Water and rocks are necessary for life and help everything else run more smoothly.	just-in-time	How is just-in-time analogous to water and rocks?
Water and rocks are analogous to just-in-time because they are both necessary for life.	just-in-time	How is just-in-time analogous to water and rocks?
Just-in-time is analogous to water and rocks because it is a natural resource that is essential to life.	just-in-time	How is just-in-time analogous to water and rocks?
The analogy between adaptive immunity and police headquerters is that both are systems that allow for the centralized management of resources. In the case of adaptive immunity, this includes the management of immune cells and their responses to pathogens. In the case of police headquerters, this includes the management of officers and their response to crime.	adaptive immunity	How is adaptive immunity analogous to police headquerters?
The analogy between adaptive immunity and police headquarters is that they are both places where important decisions are made. The immune system decides which cells to destroy and which ones to let live, while the police decide how to respond to crime.	adaptive immunity	How is adaptive immunity analogous to police headquerters?
Adaptive immunity is analogous to police headquarters in that it is the central location where all of the immune activity occurs. Additionally, both adaptive immunity and police headquarters are responsible for coordinating and directing their respective activities.	adaptive immunity	How is adaptive immunity analogous to police headquerters?
Adaptive immunity is analogous to police headquarters because it is the main center where all the immunological activity of the body takes place. It coordinates and oversees the immune response, directing and organizing the activities of different cells and tissues as they work together to fight infection or disease.	adaptive immunity	How is adaptive immunity analogous to police headquerters?
Police headquerters is analogous to adaptive immunity because it is the main location where all the decisions regarding law enforcement are made. Similarly, adaptive immunity is the central location for all decisions regarding immune system function.	adaptive immunity	How is adaptive immunity analogous to police headquerters?
Cats, mice and cake are all food items. The analogy between ohm's law and these three items is that they are all things that can be consumed.	ohm's law	How is ohm's law analogous to cats, mice and cake?
ohm's law is analogous to cats, mice and cake in that they are all laws.	ohm's law	How is ohm's law analogous to cats, mice and cake?
Cats, mice and cake are all analogous to ohm's law because they are all related in some way. Ohm's law states that the current through a conductor is proportional to the voltage across it. This analogy can be used to explain how different things are related. For example, cats and mice can be related by saying that a cat is like a high voltage while a mouse is like a low voltage. Cake can be related to this analogy by saying that cake is like an object with a lot of resistance.	ohm's law	How is ohm's law analogous to cats, mice and cake?
One analogy for Ohm's law is that it is like a cat, mouse, and cake. The cat represents the voltage, the mouse represents the current, and the cake represents the resistance. Just as a cat can catch a mouse, voltage can cause current to flow through resistance. And just as mice like to eat cake, electrons like to flow through resistances.	ohm's law	How is ohm's law analogous to cats, mice and cake?
Analogies can be helpful tools for understanding difficult concepts. In this analogy, ohm's law is like a cat. Cats are independent creatures that aren't necessarily influenced by what goes on around them. Ohm's law states that an electric current is directly proportional to the voltage applied to it. This means that the greater the voltage, the greater the electric current will be. Just as cats are unaffected by most things going on around them, ohm's law doesn't change based on what else is happening in a circuit.Mice, on the other hand, are much more influenced by their environment than cats are. If there is noise and activity going on around them, they'll be affected by it and react accordingly. In a similar way, if something changes in a circuit while electricity is flowing through it (like adding or removing resistance), then the current will change too.Lastly, cake is something that everyone enjoys! It's sweet and sugary with lots of calories - just like electricity! People love eating cake because it makes them feel good. Electricity also has positive effects; it powers our devices and keeps us connected to the world around us.	ohm's law	How is ohm's law analogous to cats, mice and cake?
Transcription is analogous to photocopying in that they are both methods of copying information. With transcription, a person will listen to an audio or video and type out what they hear. With photocopying, a person will copy text or images from one document and place them into another document.	transcription	How is transcription analogous to photocopying?
Transcription is like photocopying in that it is the duplication of information. With transcription, a copy of the genetic code is made and then used to produce a protein.	transcription	How is transcription analogous to photocopying?
Transcription is analogous to photocopying in that they are both processes of copying information. With transcription, a copy of the DNA molecule is made, and with photocopying, a copy of an image is made.	transcription	How is transcription analogous to photocopying?
Transcription is analogous to photocopying in that they are both methods of copying text or other information. Transcription involves converting spoken words into written form, while photocopying involves reproducing an image or document using a copier machine.	transcription	How is transcription analogous to photocopying?
Transcription is analogous to photocopying in that they are both copying processes.	transcription	How is transcription analogous to photocopying?
Rna polymerase is analogous to a Xerox machine because it copies the genetic information from DNA to RNA.	rna polymerase	How is rna polymerase analogous to xerox machine?
A Xerox machine copies an image onto a piece of paper. RNA polymerase copies the genetic information from one DNA molecule to another.	rna polymerase	How is rna polymerase analogous to xerox machine?
Both RNA polymerase and a xerox machine use nucleotides to make copies of DNA or other documents.	rna polymerase	How is rna polymerase analogous to xerox machine?
The analogy between RNA polymerase and a Xerox machine is that they are both machines used to make copies of something.	rna polymerase	How is rna polymerase analogous to xerox machine?
RNA polymerase is analogous to a Xerox machine because it copies DNA sequences into RNA molecules.	rna polymerase	How is rna polymerase analogous to xerox machine?
Ribosomes are analogous to cooks because they both take instructions and create something new. The ribosomes read the genetic code in DNA and create proteins based on that information. Cooks read recipes and create food based on those instructions.	ribosome	How is ribosome analogous to cook?
A ribosome is analogous to a cook in that they both work together to create something. The ribosomes put together the building blocks of proteins and the cook puts together the ingredients to make a meal.	ribosome	How is ribosome analogous to cook?
A ribosome is analogous to a cook in that they are both responsible for creating something. A ribosome creates proteins and a cook creates food.	ribosome	How is ribosome analogous to cook?
A ribosome is analogous to a cook in that they are both responsible for creating something. The ribosome creates proteins while the cook creates food.	ribosome	How is ribosome analogous to cook?
Ribosomes are analogous to cooks in that they are both responsible for creating something new. Ribosomes create proteins, while cooks create meals. Both require raw materials and both have a specific process by which they work.	ribosome	How is ribosome analogous to cook?
An activator protein is analogous to bookmarks in that they are both used to help keep track of specific points within a larger document. In the case of activator proteins, these molecules bind to specific DNA sequences and help to activate or "turn on" the nearby genes. By doing so, they essentially mark off these regions as being important and worthy of further attention. Like bookmarks, activator proteins can be helpful in keeping track of complex genetic information and ensuring that all necessary genes are activated at the correct time and place.	activator protein	How is activator protein analogous to bookmarks?
An activator protein is analogous to bookmarks in that they both help to facilitate a particular task. In the case of activator proteins, they help to turn on specific genes so that they can be expressed. Bookmarks, meanwhile, help to keep track of where you are in a document so that you can easily return to it later.	activator protein	How is activator protein analogous to bookmarks?
The activator protein binds to the promoter region of a gene and helps initiate transcription. This is analogous to bookmarks on a web page, which help identify where you are in the document and make it easy to return to that spot later.	activator protein	How is activator protein analogous to bookmarks?
Bookmarks are analogous to activator proteins because they both help keep track of where you are in a document.	activator protein	How is activator protein analogous to bookmarks?
The activator protein is analogous to bookmarks in that they both help keep track of where you are in a document or sequence. The activator protein helps keep track of the promoter region so that transcription can start. Bookmarks help keep track of your place in a document so that you can return to it later.	activator protein	How is activator protein analogous to bookmarks?
A metal ring is analogous to a closed circuit. A rope going through the rings is analogous to electricity flowing through the wires in a circuit.	electric circuit	How is electric circuit analogous to rope through metal rings?
An electric circuit can be thought of as a system of metal rings (conductors) and ropes (insulators). A current flows through the metal rings when a voltage is applied across them. The ropes are used to hold the rings in place, just as insulation is used to prevent electricity from flowing through unintended paths in an electrical circuit.	electric circuit	How is electric circuit analogous to rope through metal rings?
Electric current is analogous to air flowing through a tube. Just as the speed of the air flow depends on the size and shape of the tube, so does the electric current depend on the size and shape of the conductor.	electric circuit	How is electric circuit analogous to air flowing through a tube?
Air flows through a tube when there is a difference in air pressure on either side of the tube. An electric circuit is analogous to this when there is a difference in voltage on either side of the circuit.	electric circuit	How is electric circuit analogous to air flowing through a tube?
An electric circuit is analogous to air flowing through a tube in that they are both examples of fluid flow. In an electric circuit, electricity flows through the wires like water flows through a pipe. And just as the speed of water can be increased by increasing the diameter of the pipe, the speed of electricity can be increased by making the wire thicker.	electric circuit	How is electric circuit analogous to air flowing through a tube?
The hydrophobic effect can be analogous to teenagers at a party in that they are both trying to avoid each other. In the case of the hydrophobic effect, molecules are trying to avoid being near water because they do not like wetting their surfaces. Similarly, teenagers may try to avoid congregating in one area of the party because they do not want to be surrounded by people.	hydrophobic effect	How is hydrophobic effect analogous to teenagers at a party?
One analogy for the hydrophobic effect is that it is similar to teenagers at a party. Just as the teens want to be around each other and avoid mingling with the adults, the hydrophobic molecules want to be around each other and avoid mingling with water (the "adult").	hydrophobic effect	How is hydrophobic effect analogous to teenagers at a party?
The hydrophobic effect is analogous to teenagers at a party in that they are both attracted to each other. Hydrophobic molecules are drawn to each other, and this creates the clusters we see in water. Teens are also drawn to each other, and this creates the groups we see at parties.	hydrophobic effect	How is hydrophobic effect analogous to teenagers at a party?
Just like teenagers at a party, hydrophobic molecules are trying to avoid each other. In fact, they're so focused on avoiding each other that they form tight clusters and ignore the rest of the world around them.	hydrophobic effect	How is hydrophobic effect analogous to teenagers at a party?
Just as teenagers at a party tend to gather together in one group, hydrophobic molecules also group together when they are in contact with water.	hydrophobic effect	How is hydrophobic effect analogous to teenagers at a party?
Biological signal transduction is analogous to threat communication in animals because it is a process by which messages are transmitted from one cell to another. In both cases, the messages are transmitted through a series of steps that involve the transfer of information from one molecule to another.	biological signal transduction	How is biological signal transduction analogous to threat communication in animals?
In both cases, a message is transmitted from one entity to another. In biological signal transduction, the message is a chemical signal that conveys information about the environment or the state of the organism. In threat communication in animals, the message is a warning signal that conveys information about an impending attack.	biological signal transduction	How is biological signal transduction analogous to threat communication in animals?
Biological signal transduction is analogous to threat communication in animals because both are used to send a message from one entity to another. In biological signal transduction, the message is a chemical that conveys information about the environment or the organism. In threat communication, the message is a warning sign that something dangerous is happening.	biological signal transduction	How is biological signal transduction analogous to threat communication in animals?
Biological signal transduction is analogous to threat communication in animals because both processes allow for the exchange of information between organisms. In particular, signal transduction allows for the transmission of information from a cell's surface to its interior, while threat communication allows for the transmission of information from one animal to another. Furthermore, both processes are often rapid and can lead to changes in behavior or physiology.	biological signal transduction	How is biological signal transduction analogous to threat communication in animals?
In both cases, a signal is transmitted from one entity to another. In the case of threat communication, the signal warns of potential danger. In the case of biological signal transduction, the signal transmits information about an organism's internal state or environment.	biological signal transduction	How is biological signal transduction analogous to threat communication in animals?
