In gardening, nadh is the nutrient that helps plants turn sunlight into sugar. Without nadh, plants cannot create energy and will eventually die. In the body, nadh is responsible for turning food into energy.	nadh	Explain nadh using a gardening analogy.
Nadh is like the sun in a gardening analogy. It provides energy to the plants and helps them grow.	nadh	Explain nadh using a gardening analogy.
In gardening, nadh is the nutrient that helps plants to convert sunlight into energy. It is analogous to norepinephrine in humans, which helps to convert glucose into energy.	nadh	Explain nadh using a gardening analogy.
Proteins are like the plants in a garden. They are the structures that make up the body, and they grow and change as the body grows and changes.	proteins	Explain proteins using a gardening analogy.
A protein is like a plant in your garden. It starts out as a small seed and, with the right conditions (food, water, sunlight), it will grow into a large plant. The same is true for proteins - they start out as tiny molecules called amino acids and, with the right conditions (nutrients from food), they will grow into larger proteins.	proteins	Explain proteins using a gardening analogy.
Just as a gardener needs to add fertilizer to the soil in order to help plants grow, our bodies need protein in order to build and maintain muscle. Protein is made up of smaller molecules called amino acids, which are the "building blocks" of protein. We get most of the amino acids we need from food, but there are a few that our bodies can make on their own.	proteins	Explain proteins using a gardening analogy.
DNA is like a blueprint for the growth of a plant. It contains all of the information necessary to direct the growth and development of a plant.	dna	Explain dna using a gardening analogy.
DNA is the blueprint for life. It is like a gardening analogy because it contains all of the instructions for building and maintaining a living organism.	dna	Explain dna using a gardening analogy.
DNA is the blueprint for life. It's like a garden where you plant the seeds and then water and care for them. They will grow into plants that produce fruit. The DNA molecule is like the blueprint for these plants, telling them how to grow and what kind of fruit to produce.	dna	Explain dna using a gardening analogy.
If you think of glycogen as the soil in a garden, then glucose would be the water that is poured on top. The plants (muscles) grow and use the glucose for energy while the glycogen remains unchanged.	glycogen	Explain glycogen using a gardening analogy.
Glucose is like a seed. Glycogen is like the soil in which the seed grows. The more glycogen there is, the better the glucose can grow.	glycogen	Explain glycogen using a gardening analogy.
Glycogen is like a garden hose. It can be turned off by closing the valve at the faucet (the liver) or by uncoiling the hose from around its spool (muscles).	glycogen	Explain glycogen using a gardening analogy.
The endoplasmic reticulum can be thought of as the plumbing in a garden. It is responsible for moving water and other nutrients around the plant. In the same way, it helps to move proteins and other materials around the cell.	endoplasmic reticulum	Explain endoplasmic reticulum using a gardening analogy.
Endoplasmic reticulum is like the soil in a garden. The plant's roots (the cell nucleus) grow down into it, and the plants absorb water and nutrients from the soil. The endoplasmic reticulum also helps to store food for the plant.	endoplasmic reticulum	Explain endoplasmic reticulum using a gardening analogy.
Endoplasmic reticulum can be thought of as the piping and plumbing in a garden. It carries water and nutrients to all parts of the garden, and helps remove waste. In plants, the endoplasmic reticulum also manufactures food (sugar, starch, and proteins).	endoplasmic reticulum	Explain endoplasmic reticulum using a gardening analogy.
The golgi is like the gardening tools shed. It stores all of the tools that you might need while working in the garden, and it makes sure they are all organized and easy to find. It also helps put together new tools as you need them.	golgi	Explain golgi using a gardening analogy.
The Golgi Apparatus can be thought of as the gardeners of the cell. Just as a gardener plants seeds, waters them, and watches them grow into flowers or vegetables, the Golgi Apparatus implants proteins into the cell membrane, regulates their transport throughout the cell, and oversees their final destination.	golgi	Explain golgi using a gardening analogy.
The Golgi apparatus is like the gardener who plants the seeds, waters them, and then harvests the vegetables. The plant's cells produce the proteins that are needed for growth. These proteins are shipped to the Golgi apparatus inside small sacs called vesicles. The golgi separates and modifies these proteins before shipping them off to their final destination in the cell.	golgi	Explain golgi using a gardening analogy.
The plasma membrane can be thought of as the garden fence. It is a barrier that separates what is inside the cell from what is outside the cell.	plasma membrane	Explain plasma membrane using a gardening analogy.
The plasma membrane can be thought of as the garden fence. It is a boundary that separates the inside of the cell from the outside environment. The membrane controls what enters and leaves the cell, much like how a fence controls what enters and leaves a garden.	plasma membrane	Explain plasma membrane using a gardening analogy.
The plasma membrane can be thought of as the garden fence. It surrounds and protects the plant (cell) from the environment. The membrane controls what goes in and out of the cell, like water and nutrients.	plasma membrane	Explain plasma membrane using a gardening analogy.
Lysosomes are like a compost bin in your garden. They break down the organic matter (like leaves and food scraps) into molecules that can be used by plants to grow.	lysosome	Explain lysosome using a gardening analogy.
Lysosomes are like the garbage cans of a garden. They digest dead cells and waste products, breaking them down into their component parts so that they can be used again by the plants or removed from the garden altogether.	lysosome	Explain lysosome using a gardening analogy.
Lysosomes are similar to compost heaps in a garden. The lysosomes digest the old and damaged material in the cell, breaking it down into small molecules that can be used by the cells to create new proteins, lipids, and DNA.	lysosome	Explain lysosome using a gardening analogy.
Peroxisomes are like the sprinklers in a garden. They water the plants and help them grow.	peroxisomes	Explain peroxisomes using a gardening analogy.
Peroxisomes are like the fertilizer that helps a garden grow. They help to break down food and other molecules in the cell so that they can be used by the cells.	peroxisomes	Explain peroxisomes using a gardening analogy.
Peroxisomes can be compared to a garden hose. Just as the water from the hose can clean things by blasting them with high pressure, peroxisomes use enzymes to blast away unwanted substances in the cell.	peroxisomes	Explain peroxisomes using a gardening analogy.
Mitochondria are like the gardeners who take care of the plants in the garden. The mitochondria water and fertilize the plants, and make sure they get enough sunlight. Without the mitochondria, the plants would not be able to grow or thrive.	mitochondria	Explain mitochondria using a gardening analogy.
Mitochondria are like the gardeners who take care of the plants in the garden. The mitochondria help to create energy for the plants to grow.	mitochondria	Explain mitochondria using a gardening analogy.
Mitochondria are like the gardeners who take care of the plants in the garden. The plants get their energy from the sun, and the gardeners use that energy to help keep the plants healthy and alive.	mitochondria	Explain mitochondria using a gardening analogy.
A chloroplast is like a garden. The nucleus is the gardener, and the chloroplasts are the plants in the garden. The gardener provides water and nutrients to the plants, and the sun provides energy for photosynthesis.	chloroplast	Explain chloroplast using a gardening analogy.
A chloroplast is like a small garden in your yard. It has a soil bed, plants, and water. The plants use the sunlight to turn carbon dioxide and water into sugar and oxygen. The sugar is stored in the plant's leaves and roots. The oxygen is released into the air.	chloroplast	Explain chloroplast using a gardening analogy.
A chloroplast is like a garden. It has plants (photosynthesis), water (plasma membrane), and soil (the stroma).	chloroplast	Explain chloroplast using a gardening analogy.
A cytoskeleton analogy to gardening would be the skeleton of a house. The foundation of the house is analogous to the cytoskeleton, while the walls and roof are analogous to the cell membrane and organelles.	cytoskeleton	Explain cytoskeleton using a gardening analogy.
The cytoskeleton is like the scaffolding in a garden. It provides support to the plants and helps them grow upright.	cytoskeleton	Explain cytoskeleton using a gardening analogy.
Cytoskeleton can be thought of as the gardener's tools. Just as a gardener needs a shovel to turn over soil, cytoskeleton proteins are needed to move and shape chromosomes and other cellular components.	cytoskeleton	Explain cytoskeleton using a gardening analogy.
ATP is the energy currency of life. Just as a gardener needs to have a good supply of energy (in the form of food) in order to do work (digging, planting, weeding), cells need a good supply of ATP in order to do work (such as contracting muscles, pumping blood, synthesizing proteins).	atp	Explain atp using a gardening analogy.
The energy that plants use to make food is similar to the ATP energy used by your muscles. Just as you need gas for your lawnmower, plants need sunlight and water to create glucose from carbon dioxide and hydrogen atoms in the air. This process is called photosynthesis, and it's what makes our planet hospitable for life.	atp	Explain atp using a gardening analogy.
ATP is the energy currency of cells. Just like money in a bank account can be used to buy things, ATP molecules can be used to power cellular processes. Plants use sunlight to convert carbon dioxide and water into glucose (a type of sugar) and oxygen. The energy stored in glucose molecules is later used to produce ATP.	atp	Explain atp using a gardening analogy.
Nadph is like the water in a garden hose. It helps plants to grow by bringing nutrients from the soil to the leaves.	nadph	Explain nadph using a gardening analogy.
NADPH is like the fertilizer for plants. It helps to provide the nutrients that plants need to grow and thrive.	nadph	Explain nadph using a gardening analogy.
Plants need lots of energy to grow, and nadph is a molecule that helps them get that energy. It's kind of like the fuel that powers a car - it lets plants turn sunlight into food.	nadph	Explain nadph using a gardening analogy.
Peroxysomes are like tiny greenhouses in the plant cell. They contain enzymes that help break down toxins and wastes, including hydrogen peroxide. This allows the plant to clean up its own messes and stay healthy!	peroxysome	Explain peroxysome using a gardening analogy.
If you think of the cell as a garden, then the peroxysome would be like the sprinkler system. It's responsible for watering and fertilizing different parts of the cell.	peroxysome	Explain peroxysome using a gardening analogy.
The peroxysome is like the compost heap in a garden. The compost heap is where all of the organic matter (leaves, grass clippings, etc.) goes to decompose and release their nutrients into the soil. The peroxysome is where all of the cellular debris (dead cells, organelles, etc.) goes to be decomposed and released into the cytoplasm.	peroxysome	Explain peroxysome using a gardening analogy.
Mytochondria are like the roots of a plant. They take in nutrients from the soil and help the plant grow. Mytochondria also produce energy for the plant to use.	mytochondria	Explain mytochondria using a gardening analogy.
Mytochondria are like the roots of a plant. They anchor the cell and extract nutrients from the soil. Mytochondria also produce energy for the cell by breaking down glucose molecules.	mytochondria	Explain mytochondria using a gardening analogy.
Mytochondria are like the roots of a plant. They anchor the plant in the ground and extract nutrients from the soil. Mytochondria also produce energy for the plant to grow.	mytochondria	Explain mytochondria using a gardening analogy.
Electric forces are like when you have two magnets and they attract or repel each other. It is the same thing with electric charges-they either attract or repel each other.	electric forces	Explain electric forces using a gardening analogy.
When you are gardening, you use a hoe to move the dirt around. The hoe has a metal blade that is attracted to the dirt. This is because the atoms in the metal are attracted to the atoms in the dirt. The electric force between two objects is like this attraction between atoms.	electric forces	Explain electric forces using a gardening analogy.
Electric forces are like the gardener's trowel. Just as the gardener uses the trowel to move earth around, electric forces can move charges around.	electric forces	Explain electric forces using a gardening analogy.
A hydrogen electron's orbital can be thought of as a flowerpot. The "orbital" is the pot, and the "electron" is the plant. The plant (electron) sits in the pot (orbital) and gets its water and nutrients from the soil (the electron cloud surrounding the nucleus).	hydrogen electron's orbital	Explain hydrogen electron's orbital using a gardening analogy.
A hydrogen electron's orbital can be thought of as a flower pot. The nucleus is the plant, and the electron is one of the flowers.	hydrogen electron's orbital	Explain hydrogen electron's orbital using a gardening analogy.
A hydrogen electron's orbital can be thought of as a flower pot. The electron is the flower, and the orbital is the pot that it sits in.	hydrogen electron's orbital	Explain hydrogen electron's orbital using a gardening analogy.
The first line of defense in the body is like a garden fence. It keeps out unwanted pests and invaders so that they cannot harm the plants inside. Similarly, the first line of defense in the body is responsible for keeping out harmful bacteria, viruses, and other foreign invaders so that they cannot cause damage.	first line of defense in the body	Explain first line of defense in the body using a gardening analogy.
The first line of defense in the body is similar to a fence around a garden. This barrier is made up of skin, hair, and sweat glands that work together to keep out bacteria and other invaders.	first line of defense in the body	Explain first line of defense in the body using a gardening analogy.
One's first line of defense against invaders in the body might be thought of as analogous to a gardener's fence. The fence is intended to keep unwanted things out, and it does this by being strong and tall. Similarly, the cells that make up our skin are meant to keep bacteria and other potentially harmful substances from entering our bodies. Our skin is also tough, so it can resist damage from these outside entities.	first line of defense in the body	Explain first line of defense in the body using a gardening analogy.
A macrophage is a large white blood cell that absorbs and digests bacteria, dead cells, and other debris. Macrophages are like the gardeners of your body - they keep things clean and free from infection.	macrophages	Explain macrophages using a gardening analogy.
A macrophage can be thought of as a "garbage truck" for the body. It engulfs and digests cellular debris, bacteria, and other foreign matter.	macrophages	Explain macrophages using a gardening analogy.
Macrophages are the gardeners of your immune system. They survey your body for any signs of infection or disease, and then work to clear away any harmful cells or substances. Like a good gardener, they also help to nurture healthy cells and tissue growth.	macrophages	Explain macrophages using a gardening analogy.
In gardening, there are different types of plants that need different types of care. For example, a rose bush needs water and sunlight while a cactus does not. In the same way, t-helper cells are responsible for identifying different antigens and providing the necessary signals for an immune response.	t-helper cells	Explain t-helper cells using a gardening analogy.
The analogy of gardening is helpful in understanding how t-helper cells work. In gardening, there are different types of soil—clay, loam and sand. The type of soil that a gardener uses will depend on the plants they are growing. For example, if they want to grow tomatoes, they would use loam because it is good for holding moisture and nutrients. If they wanted to grow carrots, they would use sandy soil because it has good drainage. T-helper cells are like the type of soil; each one works best with certain antigens (like plants). There are different types of t-helper cells that work with different antigens; just as there are different types of soils that work best with certain plants.	t-helper cells	Explain t-helper cells using a gardening analogy.
A t-helper cell is like a gardener. It helps to direct and guide other cells in the body to do their jobs effectively.	t-helper cells	Explain t-helper cells using a gardening analogy.
B-lymphocytes are like the plants in a garden. They grow and multiply, then produce antibodies that help protect the body from infection.	b-lymphocytes	Explain b-lymphocytes using a gardening analogy.
B-lymphocytes are like the weeds in your garden. They grow quickly and can take over if not controlled. However, they also play an important role in the garden by helping to fight off pests and diseases.	b-lymphocytes	Explain b-lymphocytes using a gardening analogy.
B-lymphocytes are like the plants in your garden. They are responsible for taking in nutrients from the soil and turning them into things that the rest of the plant can use to grow. B-lymphocytes also produce antibodies, which help protect the plant from pests and diseases.	b-lymphocytes	Explain b-lymphocytes using a gardening analogy.
Cytotoxic T-lymphocytes can be thought of as the gardeners of the immune system. They are responsible for seeking out and destroying cancer cells and other harmful invaders in the body. Like gardeners, they use their knowledge of plants (the anatomy and physiology of cancer cells) to identify and destroy these unwanted organisms.	cytotoxic t-lymphocytes	Explain cytotoxic t-lymphocytes using a gardening analogy.
A cytotoxic t-lymphocyte is a type of white blood cell that helps the body fight infection. In a gardening analogy, they can be thought of as the gardener's helper. They work to destroy any cells that are infected or damaged, including cancer cells.	cytotoxic t-lymphocytes	Explain cytotoxic t-lymphocytes using a gardening analogy.
A cytotoxic t-lymphocyte is like a weed killer. It seeks out and destroys cells that are not supposed to be in the body, such as cancer cells.	cytotoxic t-lymphocytes	Explain cytotoxic t-lymphocytes using a gardening analogy.
Bacteria can be seen as garden pests that invade and destroy plants. Just as a gardener might use pesticides to get rid of these pests, antibiotics are used to kill bacteria.	invasion of bacterias	Explain invasion of bacterias using a gardening analogy.
A gardener may use compost to improve the soil in her garden. The compost contains bacteria, which will invade the healthy soil and help it to decompose. In a similar way, invading bacteria can help break down organic matter and improve the environment for other organisms.	invasion of bacterias	Explain invasion of bacterias using a gardening analogy.
The analogy of bacteria invading a garden is much like an infestation of ants. The ants are constantly looking for new food sources and they will invade a garden in order to get to the plants or fruits that they are looking for. The bacteria work in a very similar way. They are always looking for new ways to infect people and once they find a way in, they can quickly spread throughout the body.	invasion of bacterias	Explain invasion of bacterias using a gardening analogy.
Imagine you are a gardener. You have just planted some flowers and now you need to water them. To do this, you take a hose and put it in the ground near the plants. When you turn on the water, the pressure of the water against the ground forces liquid up through the hose and into the flower pots.Now imagine that each flower pot has a small hole in it so that liquid can escape from it (but not enter). If you turn on the water slowly, only a little bit of liquid will flow out of each pot. But if you turn on the water with more force, more liquid will flow out of each pot.This is similar to what happens when there is an action potential in a neuron. The voltage difference between inside and outside of a neuron causes sodium ions to rush into the neuron, like water rushing through holes in flower pots. This influx of sodium ions creates an electrical current that travels down the length of the neuron until it reaches its end point (the synapse). There, neurotransmitters are released which cross over to receptors on neighboring neurons where they generate another action potential	action potential	Explain action potential using a gardening analogy.
The gardener analogy for the action potential is that of a hose. When the water is turned on at full force, it gushes out of the hose. This is analogous to when the neuron fires and sends an action potential down its axon. If you turn the water on slowly, you get a dribble; this is analogous to a graded potential.	action potential	Explain action potential using a gardening analogy.
When a gardener wants to water their plants, they go over to the hose and turn it on. This allows water to flow from the faucet into the hose, and eventually out of the spout and onto the plants. The gardener can control how much water is flowing by turning the faucet on and off.In a similar way, when a neuron is stimulated, an action potential occurs. This means that voltage-gated Na+ channels open up, allowing Na+ ions to flow into the neuron. This influx of Na+ ions causes the neuron to become more positive inside (depolarization), which in turn opens up even more voltage-gated Na+ channels. As more and moreNa+ ions flow in, the membrane potential continues to increase until it reaches its peak value (+40 mV). At this point, all of the voltage-gated Na+ channels close and K+ ion channels open up, allowing K+ ions to leavethe neuron (repolarization). Once repolarized, the neuron is ready for another action potential	action potential	Explain action potential using a gardening analogy.
Chromatography is the process of separating a mixture into its individual components. This can be done using either a physical or chemical separation technique. In gardening, chromatography can be used to separate different colors of soil. The different colors are each placed in their own container and then water is slowly added until the soils are all mixed together. Once the soils are mixed, a small amount of this mixture is placed on a filter paper and allowed to dry. Once the sample has dried, it will be ready for analysis. To perform the analysis, we will need some food coloring dye and alcohol. We will also need a ruler or other measuring device with millimeter markings. First, we will use the food coloring dye to color one end of the filter paper strip red. Next, we will add alcohol to another end of the strip until it is wet but not soaking wet (this should take about 10 drops). Now we're ready to start testing our soil samples! We'll place each soil sample at one end of our strip and wait for them to travel down the strip by capillary action (the same way that water travels up through plants). The further down the strip that a particular soil sample travels, the more saturated that particular soil was with water when it was mixed with our original batch. We can use this information to create a "soil moisture" map of our garden!	experiment of chromatography	Explain experiment of chromatography using a gardening analogy.
If you want to separate the colors in a bouquet of flowers, you can use chromatography. The process works something like this: You put a few drops of water on each flower, then place them on a piece of paper. Next, you fold the paper in half and rub it together. This will cause the water to spread out and wet the entire surface of the paper. Finally, you wait for the water to dry. As it dries, it will pull the different colors in each flower apart. The result will be a colorful rainbow on the paper (see image).	experiment of chromatography	Explain experiment of chromatography using a gardening analogy.
Chromatography is used to separate the different chemicals in a mixture. A gardening analogy would be to think of each chemical as a different type of soil (clay, sand, silt). The mixture is poured into a jar and then water is added. The water will wash over the soil, carrying away some of the chemicals with it. As the water washes over the soil, it separates the chemicals based on their size and weight. The heavier soils (clay, sand) will stay at the bottom of the jar while the lighter soils (silt) will be carried away by the water.	experiment of chromatography	Explain experiment of chromatography using a gardening analogy.
The lifetime of a star is determined by how much fuel it has. A star like the sun will burn for about 10 billion years, while a red dwarf might last for trillions of years. This is kind of like comparing the lifespan of a cactus to an oak tree. The cactus has less fuel and will die sooner, while the oak has more fuel and will live longer.	main-sequence lifetimes of stars	Explain main-sequence lifetimes of stars using a gardening analogy.
The main sequence lifetime of a star is the amount of time it spends burning hydrogen in its core. This can be thought of as the length of time a gardener spends weeding their garden. Weeds will continue to grow as long as they have sunlight and water, just like a star will continue to burn hydrogen in its core as long as it has fuel.	main-sequence lifetimes of stars	Explain main-sequence lifetimes of stars using a gardening analogy.
A star's main-sequence lifetime is determined by how much nuclear fuel it has. More massive stars use up their fuel more quickly and therefore have shorter main-sequence lifetimes than less massive stars. You can think of a star's life as being like the life of a plant. The longer the plant lives, the more growth it experiences. A small, young plant will live for only a year or two, while a large, old tree may live for hundreds of years. In the same way, a small, young star will have a short main-sequence lifetime while a large, old star will have a long main-sequence lifetime.	main-sequence lifetimes of stars	Explain main-sequence lifetimes of stars using a gardening analogy.
The nucleus is the center of a plant cell. It contains the genetic information that dictates how the cell grows and functions. The nucleus is analogous to the brain of a human being, controlling all aspects of cellular activity.	nucleus	Explain nucleus using a gardening analogy.
A nucleus is like a gardener. It takes care of the plants (chromosomes) and makes sure they grow correctly.	nucleus	Explain nucleus using a gardening analogy.
A nucleus is like the center of a garden. It helps to control what grows and how it grows.	nucleus	Explain nucleus using a gardening analogy.
Ribosomes are the machines in a plant that create new proteins. They work a bit like a sewing machine, taking instructions from DNA to create new pieces of protein that are needed for the plant to grow.	ribosomes	Explain ribosomes using a gardening analogy.
Ribosomes are like the gardeners who plant and water the seeds, then watch them grow into plants. The ribosomes read the genetic information in a strand of DNA to create a specific protein.	ribosomes	Explain ribosomes using a gardening analogy.
Ribosomes are like the seeds of a plant. The seeds need water and soil in order to grow into a full-sized plant. In the same way, ribosomes need mRNA (the water) and tRNA (the soil) in order to create proteins.	ribosomes	Explain ribosomes using a gardening analogy.
The Golgi apparatus can be thought of as the gardening department of a plant. It is responsible for packaging and shipping materials to different parts of the cell, much like how a garden center might send plants and soil to different parts of a yard.	golgi apparatus	Explain golgi apparatus using a gardening analogy.
The Golgi apparatus can be thought of as a kind of gardening tool. It helps to package and label the products of the cell's production line so that they can be sent off to their correct destinations. Just like with any other garden tool, it takes some time and practice to learn how to use the Golgi apparatus properly!	golgi apparatus	Explain golgi apparatus using a gardening analogy.
The Golgi apparatus can be thought of as a gardener. The Golgi apparatus takes care of the plants (mitochondria), watering them, fertilizing them, and removing any dead plants. It also monitors the environment around the plants to make sure they are in the best possible conditions.	golgi apparatus	Explain golgi apparatus using a gardening analogy.
Lysosomes are like the garbage disposal in your kitchen sink. The trash (or food) goes into the garbage disposal, and then it is ground up and washed away. Lysosomes do the same thing to cells that are damaged or no longer needed.	lysosomes	Explain lysosomes using a gardening analogy.
Lysosomes are like a compost heap in the garden. The plant takes in food (nitrogen, phosphorus, potassium) and carbon from the air and uses it to create new leaves, flowers, fruits or vegetables. The lysosomes take the waste from the plant - leaves that have fallen off, old flowers or fruit - and break them down into their component parts so that they can be used again by the plant to create more food.	lysosomes	Explain lysosomes using a gardening analogy.
Lysosomes are like the garbage disposal in your kitchen. They digest waste and recycles materials.	lysosomes	Explain lysosomes using a gardening analogy.
A nuclear envelope is like a fence around the nucleus of a cell. It helps to keep the DNA inside and protect it from damage.	nuclear envelope	Explain nuclear envelope using a gardening analogy.
A nuclear envelope is a membrane that surrounds the nucleus of a cell. It functions as a barrier between the nucleus and the cytoplasm. The nuclear envelope is similar to the skin of a fruit or vegetable. It protects the inside of the fruit or vegetable from outside contaminants, while allowing nutrients to flow in and out.	nuclear envelope	Explain nuclear envelope using a gardening analogy.
Nuclear envelope is like a garden fence. It helps to contain the nuclear material within the cell and also regulates what goes in and out.	nuclear envelope	Explain nuclear envelope using a gardening analogy.
One way to think about vacuoles is to imagine them as holding bags of water in a plant's cells. Just as gardeners use watering cans to give their plants a drink, the vacuoles suck up water from the cell cytoplasm and store it in their bag-like membranes. This gives the plant tissue a turgid or swollen appearance, similar to how inflated balloons look different from deflated ones. The pressure of all that extra water inside the cell helps keep it rigid so it can stand up straight against gravity.	vacuoles	Explain vacuoles using a gardening analogy.
A vacuole is a bit like a garden shed. It's a small, enclosed space where you can store things. In the plant world, vacuoles are used to store water, nutrients and other important chemicals.	vacuoles	Explain vacuoles using a gardening analogy.
A vacuole is like a big bag of water that helps plants stay firm and upright. It's kind of like the water in your garden hose. When you turn on the hose, the pressure from the water coming out pushes against the sides of the hose, which in turn makes it hard for the hose to move around. The same thing happens with a plant stem - when there's more pressure inside the stem from all of that extra water in the vacuole, it becomes harder for the stem to bend or move.	vacuoles	Explain vacuoles using a gardening analogy.
The cytoplasm is like the soil in a garden. It contains all of the nutrients that the plant needs to grow and thrive.	cytoplasm	Explain cytoplasm using a gardening analogy.
The cytoplasm can be thought of as the soil in a garden. It is the foundation on which everything else grows. The cytoplasm contains all of the nutrients and water that plants need to thrive.	cytoplasm	Explain cytoplasm using a gardening analogy.
The cytoplasm is like the soil in a garden. It contains all of the nutrients that the plant needs to grow and thrive.	cytoplasm	Explain cytoplasm using a gardening analogy.
Chromosomes are like the seeds in a packet of vegetable seeds. The packet may have 20 or more different types of seeds, but each seed is still just a small part of the whole. Veggies grow from these little seeds, and as they grow, they become separate plants with their own unique qualities (some are green while others are purple; some taste sweet while others are bitter). Inside each plant, you'll find even more little seeds called chromosomes. Just like the big packet of seeds that started everything, chromosomes contain all the information needed to create a new living being.	chromosome	Explain chromosome using a gardening analogy.
Chromosomes are like the branches of a tree. They start off small and grow larger as they get further from the trunk. The leaves on the end of the branches are called chromosomes.	chromosome	Explain chromosome using a gardening analogy.
A chromosome is like a garden hose. It is long and flexible, and can be easily bent and twisted to fit into tight spaces. Chromosomes are made up of DNA, which is like the water that flows through the hose.	chromosome	Explain chromosome using a gardening analogy.
The cytosol is like the soil in a garden. It provides a place for the plants to grow, and it contains all of the nutrients that the plants need to survive.	cytosol	Explain cytosol using a gardening analogy.
The cytosol is like the soil in a garden. It provides a place for the plant to grow, and it contains all of the nutrients that the plant needs to survive.	cytosol	Explain cytosol using a gardening analogy.
The cytosol is like the soil in a garden. The plant's roots grow down into the soil, and the plant's shoots grow up out of the soil. The cytosol is where all of the plant's nutrients are stored, and it is also where the plant's cells divide and grow.	cytosol	Explain cytosol using a gardening analogy.
A cell is like a garden. The nucleus is the sun, and the chromosomes are the plants. The cytoplasm is the soil, and the organelles are the tools that help keep everything running smoothly.	cell	Explain cell using a gardening analogy.
A cell is like a small garden. It has a fence around it to keep things in, and soil to grow things in. It has a sun to give it light, and water to help it grow.	cell	Explain cell using a gardening analogy.
Your garden analogy is great! I would explain a cell as the individual plants in your garden. Each plant has its own unique set of DNA (the instructions for how to grow) and can function independently, but they are all part of the same system.	cell	Explain cell using a gardening analogy.
A vesicle is like a small balloon. It is made of thin, flexible material and has a small opening at one end. The opening can be sealed shut to keep things inside the vesicle.	vesicles	Explain vesicles using a gardening analogy.
A vesicle is like a tiny garden plot. Seeds (molecules) are planted in the soil (the matrix of the vesicle), and water is added to help them grow. As the seeds grow, they produce shoots and leaves (new proteins). The size and shape of the garden plot (vesicle) depends on how much space is available in the soil.	vesicles	Explain vesicles using a gardening analogy.
A vesicle is like a small garden shed. The shed has walls that keep the contents inside, and a door that can be opened to get in and out. The shed can hold tools, plants, or anything else that fits inside.	vesicles	Explain vesicles using a gardening analogy.
The cell wall is like a fence around a garden. It helps to keep things in (the plant cells) and out (foreign objects).	cell wall	Explain cell wall using a gardening analogy.
The cell wall is like a fence that surrounds the garden and keeps the plants inside. It's made of strong materials that can keep out pests and diseases.	cell wall	Explain cell wall using a gardening analogy.
The cell wall is analogous to a fence around a garden. It helps to keep things in (the garden) and keeps things out (outside).	cell wall	Explain cell wall using a gardening analogy.
Cells are like the flowers in a garden. They are small and numerous, and they work together to make the garden look beautiful.	cells	Explain cells using a gardening analogy.
A cell is like a garden. The nucleus is the gardener, and the chromosomes are the plants.	cells	Explain cells using a gardening analogy.
In a garden, plants need three things to survive: water, air, and soil. Plants get water from the soil; they get their carbon dioxide from the air; and they get their nutrients from the soil. The cells in our bodies are similar - we need food (nutrients), oxygen, and water to survive.	cells	Explain cells using a gardening analogy.
The cell membrane can be thought of as a garden fence. The fence is made up of metal posts and wire mesh. The posts are the cells and the wire mesh is the membrane.	cell membrane	Explain cell membrane using a gardening analogy.
The cell membrane is like a garden fence. It keeps things in (or out) of the cell while still allowing important things to pass through.	cell membrane	Explain cell membrane using a gardening analogy.
The cell membrane can be thought of as a garden fence. The fence is made of metal wires, and it surrounds the garden to keep the plants inside the garden. The fence also prevents animals from coming into the garden and eating the plants. In the same way, the cell membrane surrounds and protects the cells from outside invaders (such as bacteria) and keeps what's inside the cell separated from what's outside.	cell membrane	Explain cell membrane using a gardening analogy.
The golgi body can be thought of as the gardener. It is responsible for taking care of and processing all of the materials that go into making a plant thrive. The golgi body receives proteins and other molecules from the cell's organelles, modifies them, and then exports them to where they are needed in the plant.	golgi body	Explain golgi body using a gardening analogy.
The golgi body is like the gardening shed in your backyard. It's a small, inconspicuous building where you store all of your garden tools and supplies. The golgi body is responsible for packaging and shipping proteins out of the cell, just as you might package and ship tools and supplies out of your gardening shed.	golgi body	Explain golgi body using a gardening analogy.
A golgi body is like a gardener. It takes the products of the cell's activities, packages them up, and sends them off to their appropriate destinations.	golgi body	Explain golgi body using a gardening analogy.
A capacitor is like a container of water. If you have two containers, one with more water and one with less, the one with more water will be harder to push down. This is because it has more capacitance. Just like in a garden, the plants that have more water (capacitance) in their soil are harder to move than the plants that have less water.	capacitance	Explain capacitance using a gardening analogy.
Capacitance is the ability of a material to store an electric charge. It is measured in farads and can be increased by adding more plates to the capacitor or by using a material with a high dielectric constant. A gardening analogy would be to think of capacitance as being similar to water storage in a rain barrel. The more water that is stored, the more capacitance there is.	capacitance	Explain capacitance using a gardening analogy.
If you have ever planted a garden, you know that you need to water it regularly for the plants to grow. The water is like electricity and the plants are like capacitors. If you don't water the plants regularly, they will die.	capacitance	Explain capacitance using a gardening analogy.
Electric current is like the flow of water in a garden hose. Just as the water pressure creates a steady flow through the hose, an electric potential (or voltage) applied to one end of a wire will create a steady flow of electrons through the wire.	electric current	Explain electric current using a gardening analogy.
Electric current is like water flowing through a hose. Just as the water pressure in the hose depends on how much water is coming out of the faucet, the electrical voltage in a wire depends on how much electric charge is moving through it. The more water that's flowing, the higher the pressure (voltage). And just as you can stop the flow of water by closing off the valve, you can stop or slow down electric current by adding a resistor.	electric current	Explain electric current using a gardening analogy.
Electric current is like water flowing through a garden hose. Just as the amount of water (current) flowing through the hose can be controlled by turning the faucet on and off, the amount of electric current passing through a wire can be controlled by a switch.	electric current	Explain electric current using a gardening analogy.
A voltage is like water pressure. Just as garden hoses need a certain water pressure to spray the water further away, electrical devices need a certain voltage (pressure) to work properly.	voltage	Explain voltage using a gardening analogy.
The voltage in a garden is analogous to the water pressure. Just as water pressure can be used to move water through pipes, voltage can be used to move electricity through wires.	voltage	Explain voltage using a gardening analogy.
Water pressure is like voltage. Just as garden hoses can have different water pressures, electrical circuits have different voltages. The higher the water pressure in a hose, the more force the water will have when it comes out of the hose. The same is true for electricity – the higher the voltage in an electrical circuit, the more force (or amps) the current will have when it flows through that circuit	voltage	Explain voltage using a gardening analogy.
One way to think of the specialization and communication within a cell is to use the analogy of gardening. In gardening, there are many different types of plants that need to be planted in order to create a successful garden. The same is true for cells – they contain many different specialized parts that work together to create a functioning whole.In addition, just as in gardening, it is important for the different plants (or cells) to communicate with one another in order to coordinate their activities. For example, if one part of the garden is trying to bloom but another part is trying to grow new leaves, there will be conflict and the plant will not thrive. Similarly, if one part of a cell is trying to produce energy while another part is trying to store information, there will be conflict and the cell will not function properly.	specialization and communication in a cell	Explain specialization and communication in a cell using a gardening analogy.
In a cell, specialization is like having different parts of the garden perform different tasks. The roots take in water and nutrients from the soil, the stem transports these substances up to the leaves, and the leaves use sunlight to produce food for the plant. Communication between these parts is necessary for the plant to grow and thrive. For example, if the roots don't get enough water, they will send a signal to the stem telling it to bring more water up from the ground.	specialization and communication in a cell	Explain specialization and communication in a cell using a gardening analogy.
In gardening, plants need specific nutrients to grow and thrive. Nitrogen is one of these essential nutrients; without it, plants will not be able to produce the chlorophyll necessary for photosynthesis. A gardener can provide nitrogen to a plant in two ways: by adding a nitrogen-rich fertilizer to the soil, or by planting a legume nearby that will "fix" atmospheric nitrogen into a form the plant can use.Similarly, cells need specific nutrients (such as oxygen and glucose) to function properly. The cell membrane allows certain molecules (including nutrients) inside while keeping others out. Once inside, the molecule passes through specializations called organelles, which perform different tasks such as producing energy or building proteins. Finally, the protein exits the cell and performs its assigned task.	specialization and communication in a cell	Explain specialization and communication in a cell using a gardening analogy.
The voltage law is like a gardener who waters her plants. The voltage law states that the total voltage around a loop is zero. This means that the amount of water going into a plant (the voltage) must be equal to the amount of water coming out of the plant (the current).	kirchoff's voltage law	Explain kirchoff's voltage law using a gardening analogy.
Imagine you are a gardener trying to water your plants. You have a hose with two nozzles, one at the top and one at the bottom of the garden. If you turn on both nozzles, water will flow out of the top nozzle and fill up the garden until it reaches the level of the bottom nozzle. The same thing happens with electricity: if you have two voltage sources (like two batteries), current will flow from the higher voltage source to the lower voltage source until they reach equilibrium.	kirchoff's voltage law	Explain kirchoff's voltage law using a gardening analogy.
A gardener is tending her garden. She notices that the plants in one part of the garden are wilting, while the plants in another part of the garden are thriving. The gardener concludes that there must be something wrong with the water supply in the wilting section of the garden. This is analogous to Kirchoff's Voltage Law, which states that "The sum of all voltages around a closed loop is zero." In other words, if you add up all of the voltages in a circuit, they should sum to zero.	kirchoff's voltage law	Explain kirchoff's voltage law using a gardening analogy.
Density waves are like a ripple in a garden pond. Just as the ripples move across the surface of the water, density waves move throughmatter. The wave is created when something disturbs the equilibrium state of matter. For example, when you drop a rock into a pond, it creates a ripple that moves outward from the point of impact.	nature of a density wave	Explain nature of a density wave using a gardening analogy.
A density wave is often described as a ripple of energy that travels through a medium. This analogy can be helpful in understanding what a density wave is and how it behaves. Imagine you are standing in your garden and you toss a stone into the middle of the pond. The stone creates a ripple that quickly spreads out across the surface of the water. A density wave works in much the same way; it is created by some type of disturbance and then quickly spreads out through the material it is travelling through.	nature of a density wave	Explain nature of a density wave using a gardening analogy.
A density wave can be thought of as a wave of gardeners arriving at a new section of the garden. The first gardener to arrive starts digging a hole and planting seeds. Once the hole is dug, the second gardener arrives and plants his or her seeds next to the first, then digs another hole. This process continues until all the available space has been filled.	nature of a density wave	Explain nature of a density wave using a gardening analogy.
Enzymes are like tiny gardeners that help plants grow. They work inside the plant to make it stronger and help it grow taller.	enzymes	Explain enzymes using a gardening analogy.
Enzymes are like tiny gardeners that help to speed up chemical reactions in the body. Just as a gardener uses a shovel and hoe to speed up the process of turning over soil, enzymes use their "tools" to help convert food into energy.	enzymes	Explain enzymes using a gardening analogy.
One way to think about enzymes is to imagine them as gardeners. Just as a gardener uses a shovel and hoe to help the plants in their garden grow, enzymes use their “tools” (amino acids) to help build new proteins.	enzymes	Explain enzymes using a gardening analogy.
The human active memory system can be compared to a gardener. Just as the gardener must constantly water and weed their garden, the human brain must also frequently activate memories in order to keep them from decaying. In addition, just as the gardener needs to select the right plants for their garden, the human brain must also choose which memories to store and which ones to forget.	human active memory system	Explain human active memory system using a gardening analogy.
The human active memory system can be explained using a gardening analogy. The human brain can be thought of as the garden, and memories can be thought of as flowers. When a person needs to remember something, they plant a seed in their brain (by encoding the memory). Over time, the seed will grow into a flower (the memory will become stronger). If the person uses the information they have learned, they will water the flower (by practicing retrieval). This will help make the flower stronger and keep it from wilting.	human active memory system	Explain human active memory system using a gardening analogy.
The human active memory system can be likened to a gardener who plants seeds, waters them, and then harvests the crops. The seeds represent information that is initially stored in the brain. The watering represents the act of learning new information. The harvesting represents the act of recalling information from memory.	human active memory system	Explain human active memory system using a gardening analogy.
The rate-determining step of a reaction is the slowest step in the reaction. In a gardener analogy, this would be like trying to pull a weed that has its roots deeply embedded in the soil. It will take more time and effort to remove the weed than if it were just sitting on top of the soil.	rate-determining step of a reaction	Explain rate-determining step of a reaction using a gardening analogy.
One analogy for rate-determining step is gardening. The rate-determining step of a reaction is the slowest step in the process. In gardening, if you want to get your plants to grow quickly, you need to focus on watering and fertilizing the soil in the area where the plants are growing. If you only water or fertilize the plants themselves, it will take much longer for them to grow because those are not the steps that are limiting growth.	rate-determining step of a reaction	Explain rate-determining step of a reaction using a gardening analogy.
The rate-determining step is the slowest step in a reaction. In order to analogy this to gardening, imagine you are trying to weed your garden. The first few weeds might come up easily, but once you get down to the tougher ones, it takes more effort and time to pull them out. This is analogous to the rate-determining step: it is harder for molecules to react at this point, so the reaction occurs slower here.	rate-determining step of a reaction	Explain rate-determining step of a reaction using a gardening analogy.
Column chromatography is a technique used to purify compounds. The sample is mixed with a solvent that will dissolve the compound. The mixture is then poured into a column filled with silica gel or alumina. The solvent flows through the column and dissolves the compound. The compound travels along with the solvent until it reaches an end of the column. At this point, the compound separates from the solvent and can be collected.	column chromatography	Explain column chromatography using a gardening analogy.
Column chromatography is like using a colander to rinse dirt off of vegetables. The column is filled with small particles (the vegetable) that are packed closely together. A solvent (water) is poured over the top of the column and flows down through the packing, carrying away any material that is dissolved in it. Thesolvent then flows out the bottom of the column, leaving behind any solids that were not dissolved.	column chromatography	Explain column chromatography using a gardening analogy.
Column chromatography is like using a garden hose to water your flowers. You attach the hose to the faucet and turn on the water. The water flows through the hose and out the end, watering your flowers. Column chromatography works in a similar way. The solvent travels through the column, separating the compounds as it goes.	column chromatography	Explain column chromatography using a gardening analogy.
A garden is a good analogy for chemical equilibrium. In both, you have plants that need water, sunlight, and nutrients to grow. The gardener provides these things in the right amounts and at the right times so that the plants can reach their full potential. If there is too much or too little of any one thing, it will adversely affect the plant. Analogously, if there is too much or too little of a particular chemical in a system, it will upset equilibrium.	dynamic chemical equilibrium	Explain dynamic chemical equilibrium using a gardening analogy.
A gardener is watering a plant. The water is the reactant and the plant is the product. The more water that is added, the more product there will be (the plant will grow). As long as water continues to be added, both the reactant and product will continue to increase until there is an equilibrium reached where the amount of reactant equals the amount of product.	dynamic chemical equilibrium	Explain dynamic chemical equilibrium using a gardening analogy.
Dynamic chemical equilibrium is like a gardener maintaining a garden. The gardener must keep the plants watered and fertilized, but also must allow for some time when the plants can grow on their own. If the gardener waters and fertilizes the plants too much, they will not be able to grow. If the gardener does not water or fertilize them enough, the plants will die.	dynamic chemical equilibrium	Explain dynamic chemical equilibrium using a gardening analogy.
A vacuole is like a garden shed. It's a small, enclosed space where you can store tools and other gardening supplies.	vacuole	Explain vacuole using a gardening analogy.
The plant cell analogy for a vacuole is a water balloon. The balloon is full of water and surrounded by the rubber of the balloon. The water represents the cytoplasm in the cell and the rubber represents the plasma membrane. The vacuole is like a container inside of the cell that holds all of the liquid.	vacuole	Explain vacuole using a gardening analogy.
A vacuole is like a garden hose that can be squeezed to release water. The plant cell has a membrane around it that controls the amount of water inside the cell. The vacuole is a storage area for water and other materials.	vacuole	Explain vacuole using a gardening analogy.
Transport vesicles are like tiny garden sheds that carry tools, plants, and other supplies to different areas of the garden.	transport vesicles	Explain transport vesicles using a gardening analogy.
Lets say you have a garden and you want to move some dirt from one part of the garden to another. You can do this by picking up a shovelfull of dirt and carrying it to the other side. This is like transport vesicles transporting molecules within the cell. Alternatively, you could use a wheelbarrow to carry the dirt. This is like intracellular transport proteins that form vesicles carrying molecules across the cell membrane.	transport vesicles	Explain transport vesicles using a gardening analogy.
A transport vesicle can be thought of as a small package that is delivered from one part of the garden to another. The package is filled with goodies (like fertilizer) that will help the plants in the new location grow better.	transport vesicles	Explain transport vesicles using a gardening analogy.
A proto-oncogene is like a weed in the garden. It's not harmful at first, but if it's left to grow, it can become a problem.	proto-oncogenes	Explain proto-oncogenes using a gardening analogy.
A proto-oncogene is like a weed in your garden. It's not harmful at first, but if it's left unchecked, it can grow out of control and become a real problem.	proto-oncogenes	Explain proto-oncogenes using a gardening analogy.
A proto-oncogene could be thought of as a weed in the garden. It is something that shouldn't be there, but it pops up anyway and can cause problems.	proto-oncogenes	Explain proto-oncogenes using a gardening analogy.
In gardening, oncogenes would be the weed killer. They are genes that can cause cancer.	oncogenes	Explain oncogenes using a gardening analogy.
An oncogene is a gene that can cause cancer. In analogy to gardening, it would be like having a weed in your garden that keeps growing and taking over the other plants. The weed is the oncogene, and it is constantly reproducing and spreading its cancerous cells throughout the garden (the body).	oncogenes	Explain oncogenes using a gardening analogy.
Oncogenes are like weed seeds. Normally, they are dormant and don't cause any problems. However, if something happens to activate them (like getting exposed to too much sunlight), they can start growing out of control and become cancerous.	oncogenes	Explain oncogenes using a gardening analogy.
A tumor suppressor gene is a bit like a weed killer for the garden of your cells. It helps to keep tumors from growing by stopping cancer cells from dividing and spreading.	tumor suppressor genes	Explain tumor suppressor genes using a gardening analogy.
A tumor suppressor gene is like a weed-killing herbicide. It helps to prevent tumors from forming by killing off any abnormal cells before they have a chance to grow and become cancerous.	tumor suppressor genes	Explain tumor suppressor genes using a gardening analogy.
Suppressor genes can be thought of as the gardener in your garden. They work to keep everything in check and make sure that things are growing properly. In the same way, tumor suppressor genes help to prevent tumors from forming by keeping cell growth under control.	tumor suppressor genes	Explain tumor suppressor genes using a gardening analogy.
A brittle software system is one that doesn't tolerate changes well. A gardening analogy would be to think of a fragile plant that can easily be broken or uprooted. Similarly, a brittle software system is prone to breaking when changes are made, and it can be difficult to fix them once they're damaged.	brittle software	Explain brittle software using a gardening analogy.
If you think of software as a plant, then brittle software would be one that is very delicate and easily broken. It might not be able to withstand changes in the environment or even slight bumps or knocks.	brittle software	Explain brittle software using a gardening analogy.
Brittle software is like a brittle garden hose. It's weak and easily broken, making it difficult to use and frustrating for the gardener.	brittle software	Explain brittle software using a gardening analogy.
In gardening, resonance hybridization is similar to creating a new type of flower by crossing two different types of flowers. In this analogy, the two different types of flowers would represent the two atomic orbitals that are used in the hybridization process. The result of this process is a new orbital that is formed as a result of the combination of the two original atomic orbitals.	resonance hybrid	Explain resonance hybrid using a gardening analogy.
When you water your garden, the water flows from the hose until it reaches the end of the hose and then it stops. If you want to get more water to your plants, you can hold the hose in one hand and use your other hand to move it up and down. This causes a vibration in the hose that travels down to the end, making more water flow out. In a similar way, when electrons are added to an atom or molecule, they flow until they reach what is called an "electron acceptor" and then they stop. If you want to add more electrons, you can vibrate (or energize) the atom or molecule by adding energy to it, which will cause more electrons to flow in.	resonance hybrid	Explain resonance hybrid using a gardening analogy.
A resonance hybrid is a model of a molecule that uses simplified pictures of the electron orbitals. The pictures are called "resonance structures." In each resonance structure, one or more electrons occupy an orbital in different ways. The resonance hybrid is the combination of all the resonance structures. It shows how the electrons are actually distributed in the molecule.To understand it using a gardening analogy, think about tomatoes growing on a vine. There are many possible ways to picture the atoms and molecules in a tomato plant. However, there is only one way that the atoms and molecules exist in reality (the actual tomato plant). That's what we call the resonance hybrid. It shows how all of the possible pictures fit together to create something real (in this case, a tomato plant).	resonance hybrid	Explain resonance hybrid using a gardening analogy.
A wave mechanical model is like a garden hose. If you turn on the water and hold the hose up in the air, you will see a series of waves traveling down the length of the hose. These waves are created by the movement of the water at the faucet. The same thing happens when a sound wave travels through the air. The movement of the object that creates the sound (the speaker) causes a series of waves to travel through the air.	wave mechanical model	Explain wave mechanical model using a gardening analogy.
When you water your garden, the soil becomes more saturated and can't hold any more water. The excess water spills over and flows down to lower areas in the garden. A similar thing happens with sound waves. When a sound wave hits a surface, it causes the molecules on that surface to vibrate. If there is too much energy for those molecules to handle, they will start spilling over into adjacent areas, creating new sound waves. This process continues until the energy of all of the waves has dissipated	wave mechanical model	Explain wave mechanical model using a gardening analogy.
A wave mechanical model can be thought of as a gardener watering her plants. The gardener starts at one end of the garden and waters each plant in turn. She then moves to the next row and waters each plant, and so on. As she moves down the garden, water is traveling along with her from plant to plant. This is analogous to how a wave travels through space.	wave mechanical model	Explain wave mechanical model using a gardening analogy.
When you water your garden, the water flows down through the soil and into the roots of the plants. The plants use the water to grow, and as they do, they release some of it back up into the soil. This process creates a suction that draws more water up from underground.In much the same way, when you send an electrical signal through your brain, it travels down through neurons until it reaches a point where it can be used by muscles or other cells. As this signal spreads out, some of it is reflected back up to the surface of the brain. This returning signal is what's detected by an electroencephalogram (EEG), allowing doctors to see how active different parts of your brain are at any given time.	electroencephalogram	Explain electroencephalogram using a gardening analogy.
An electroencephalogram is a test that measures the electrical activity of your brain. It's like taking a picture of your brain's garden. The test can help doctors see if there is anything wrong with your brain, such as a tumor or an infection.	electroencephalogram	Explain electroencephalogram using a gardening analogy.
An electroencephalogram (EEG) is a test that measures the electrical activity of your brain. This test can be used to see how well your brain is working and if there are any problems with it. To think about this in terms of gardening, an EEG would be like checking the soil to see if it has enough water, nutrients, and oxygen for healthy plant growth.	electroencephalogram	Explain electroencephalogram using a gardening analogy.
When a gardener plants a new seed, she provides the seed with all of the resources it needs to grow into a plant. The gardener takes care of the soil, watering and fertilizing it as needed. Over time, the plant grows taller and stronger, thanks to the resources provided by the gardener. In a similar way, DNA replication is an essential process that allows cells to grow and divide. During replication, DNA molecules are copied so that each new cell has its own set of genetic instructions. Like the gardener providing resources to help a young plant grow tall and strong, proteins called enzymes help copy DNA strands during replication.	dna replication	Explain dna replication using a gardening analogy.
Replication is like making a copy of a document. The original document is the template for the new copies. DNA replication works in a similar way. The DNA molecule is the template for making new copies of itself.	dna replication	Explain dna replication using a gardening analogy.
When a gardener plants a new seed, they expect it to grow into a plant. In the same way, when DNA is replicated, the original DNA molecule is split in two and each half becomes an identical copy.	dna replication	Explain dna replication using a gardening analogy.
RNA transcription is like planting a garden. The first step is to dig a hole in the ground and put in the seeds. Next, you need to water the plants and give them sunlight. Over time, they will grow bigger and produce fruits or vegetables.	rna transcription	Explain rna transcription using a gardening analogy.
Transcription is similar to planting a garden. The first step is to dig a hole in the ground and put the seeds in. Next, you need to water the seeds and make sure they get enough sunlight. Over time, the seeds will grow into plants and produce flowers or fruit.	rna transcription	Explain rna transcription using a gardening analogy.
RNA transcription is similar to watering a garden. The plants in the garden are like the genes, and the water is like the RNA. When you water the plants, they get energy and grow. When you transcribe DNA into RNA, it provides energy for protein synthesis.	rna transcription	Explain rna transcription using a gardening analogy.
The analogy of protein translation using gardening is as follows: the mRNA is like a seed, the ribosomes are like the garden plot, and the tRNA are like the gardener's hands. The mRNA enters into the ribosome, and is "read" by codons (the letters). Each codon corresponds to an amino acid, which is then added to the end of a growing peptide chain (like a plant).	protein translation	Explain protein translation using a gardening analogy.
Protein translation is like a gardener planting seeds and watering them. The seeds are the mRNA, and the water is the ribosomes. The gardener provides all of the necessary nutrients for the plants to grow, just as the ribosomes provide all of the necessary nutrients for translation to occur.	protein translation	Explain protein translation using a gardening analogy.
In analogy to protein translation, think of a gardener who plants seeds in the ground. The gardener provides water and sun for the seeds, and over time they grow into plants. The plants then produce fruits or vegetables. In the same way, the DNA code is like the seeds, while proteins are like the plants and fruits/vegetables. During protein translation, specific sequences of codons (the "letters" of DNA) are read off of one DNA strand and used as instructions to create a particular protein molecule chain.	protein translation	Explain protein translation using a gardening analogy.
In gardening, an ecosystem is often represented by a miniature ecosystem in a pot. This microcosm contains everything necessary for the plants inside it to thrive, including soil, water, air, light and nutrients. The gardener provides some of these things - such as watering and fertilizing - but most of what the plants need comes from their environment. In this way, the mini-ecosystem can be seen as a self-sufficient system in which all of the parts work together to create balance.	ecosystem	Explain ecosystem using a gardening analogy.
A garden is an ecosystem. The plants and animals in the garden interact with each other to create a self-sustaining system. The plants provide food and shelter for the animals, and the animals help to pollinate the flowers and spread seeds.	ecosystem	Explain ecosystem using a gardening analogy.
A garden is a great analogy for an ecosystem. It has many different parts that all work together to create a functioning system. The soil is like the earth, providing nutrients and structure for the plants. The plants are like the animals in an ecosystem, consuming resources and creating waste products. The insects and other creatures that live in the garden are like the bacteria and fungi in an ecosystem, breaking down wastes and helping to recycle materials. Finally, the gardener is like the human beings in an ecosystem, managing inputs and outputs to keep things running smoothly.	ecosystem	Explain ecosystem using a gardening analogy.
Action potentials are like the electric current in a garden hose. If you turn on the faucet at one end of the hose, water will flow towards the other end. This is because the pressure of the water (action potential) is greater at one end than at the other. The same thing happens with action potentials in neurons. The voltage (pressure) of an action potential is greatest at the beginning of the neuron and decreases as it moves down the neuron.	propagation of an action potential down a neuron	Explain propagation of an action potential down a neuron using a gardening analogy.
The propagation of an action potential down a neuron can be thought of as the spreading of a wave of water in a garden hose. The initial force (action potential) creates a ripple that travels down the length of the hose. This ripple is then followed by more ripples, each one traveling slightly slower than the one before it.	propagation of an action potential down a neuron	Explain propagation of an action potential down a neuron using a gardening analogy.
The propagation of an action potential down a neuron can be likened to the propagation of water droplets down a garden hose. Just as the water droplets follow the path of least resistance, so do action potentials propagate along the neuron in the direction that allows them to travel most quickly.	propagation of an action potential down a neuron	Explain propagation of an action potential down a neuron using a gardening analogy.
A frog's breathing mechanism is similar to that of a human. Air enters the lungs, and the oxygen in the air is exchanged for carbon dioxide. The carbon dioxide is then expelled from the body when the frog exhales.	breathing mechanism of frogs	Explain breathing mechanism of frogs using a gardening analogy.
The frog's breathing mechanism can be likened to a garden sprinkler. The frog's body is like the soil, and its lungs are like the sprinkler head. When the frog inhales, it pulls in air through its nose or mouth. This air passes through the trachea (windpipe), which splits into two bronchi (air tubes). The bronchi lead to the frogs' lungs, where oxygen enters the blood and carbon dioxide leaves. When the frog exhales, it pushes out carbon dioxide from its lungs	breathing mechanism of frogs	Explain breathing mechanism of frogs using a gardening analogy.
When you water your plants, the water travels from the soil up through the plant and out of the leaves. This same process happens in a frog's lungs when it breathes. The frog's stomach is like the soil, and its lungs are like the leaves. When it inhales, air travels down into its lungs and mixes with the blood. When it exhales, carbon dioxide from the blood flows back out of its lungs and into the air.	breathing mechanism of frogs	Explain breathing mechanism of frogs using a gardening analogy.
Just as a gardener might use different types of soil and plants in layers to create a beautiful garden, computer architects also use layered architecture to create efficient and reliable systems. The lowest layer is the hardware, which provides the basic structure and functions of the system. Next is the firmware, which controls how the hardware works and interacts with other parts of the system. Above that are various levels of software, including the operating system (OS), application programs, and utilities. Finally, there are user interface elements such as menus, buttons, and windows that allow users to interact with the system.	layered architecture	Explain layered architecture using a gardening analogy.
If you gardened, you might think of the different layers in your garden as the soil, plants, and mulch. The soil is the foundation on which everything else is built. The plants are the stars of the show, but they need something to protect them from the sun and wind. Mulch does just that; it keeps moisture in the soil and prevents weeds from growing.	layered architecture	Explain layered architecture using a gardening analogy.
Layers in gardening are typically thought of as plants that are grown one on top of the other, with different depths and types of soil to accommodate their growth. The uppermost layer is called the canopy and usually consists of taller trees or shrubs. Beneath that is the understory, which contains smaller plants and trees. The next layer down is composed of herbs, with groundcover rounding out the bottom layer.Just like in a garden, a layered architecture has several layers of functionality, each serving different needs and providing different benefits. The topmost layer is generally for user interaction and serves as an entry point into the system. Beneath that is the business logic layer, which handles all the back-end processing required to fulfill user requests. Next down is the data storage layer, where all persistent data is kept. Finally, at the bottom we have the infrastructure layer, which provides basic services such as networking and file management.	layered architecture	Explain layered architecture using a gardening analogy.
A limiting reactant is a chemical that limits the amount of product that can be formed in a chemical reaction. An excess reactant is a chemical that is present in more than the required molar amount to produce the desired quantity of product. In gardening, think about it as if you have two pots of flowers - one with petunias and one with marigolds. If you want to grow more petunias, you need to use up all the potting soil in your pot with petunias before adding any soil to your pot of marigolds. The same concept applies in chemistry - if there isn't enough limiting reactant available, then no matter how much excess Reactant A you add, Reactant B will not form any product.	limiting reactant and excess reactant	Explain limiting reactant and excess reactant using a gardening analogy.
In gardening, the limiting reactant is the one that runs out first. It's the part of the reaction that limits how much product can be made. The excess reactant is the part of the reaction that's left over after the limiting reactant has run out.	limiting reactant and excess reactant	Explain limiting reactant and excess reactant using a gardening analogy.
A limiting reactant is a reactant that's used up first in a chemical reaction. The excess reactant is the leftover reactant after the limiting reactant runs out. In gardening, think of the limiting reactant as the seed and the excessreactant as the soil. The seed is used up first and then there's no more left to grow plants.	limiting reactant and excess reactant	Explain limiting reactant and excess reactant using a gardening analogy.
A eukaryotic cell is like a garden. The nucleus is the gardener, who takes care of everything inside the cell. The mitochondria are the plants in the garden, and they produce energy for the cell. The cytoskeleton is like the fence around the garden, keeping everything organized.	eukaryotic cell	Explain eukaryotic cell using a gardening analogy.
A eukaryotic cell is like a garden with different plants and flowers. The plants are the organelles and the flowers are the DNA. The gardener is the nucleus and it controls everything in the garden.	eukaryotic cell	Explain eukaryotic cell using a gardening analogy.
A eukaryotic cell is like a garden. The nucleus is the gardener, who oversees everything that goes on in the garden and makes sure it grows properly. The mitochondria are the plants in the garden, providing energy to make things grow. The chloroplasts are the sun, giving light and warmth to help everything thrive.	eukaryotic cell	Explain eukaryotic cell using a gardening analogy.
A prokaryotic cell can be thought of as a seed. The nucleus is the center of the cell and contains all of the genetic information for the organism. The cytoplasm surrounds the nucleus and contains all of the cellular machinery necessary for life. Prokaryotic cells are small and simple, making them easy to grow and multiply.	prokaryotic cell	Explain prokaryotic cell using a gardening analogy.
A prokaryotic cell is like a small garden plot. The cells are small and there is no defined shape to the garden. The soil in the garden is loose and everything grows together without much order.	prokaryotic cell	Explain prokaryotic cell using a gardening analogy.
A prokaryotic cell is like a small garden plot. It has all the elements necessary to grow plants - soil, water, and sunlight. But it doesn't have a defined shape or borders.	prokaryotic cell	Explain prokaryotic cell using a gardening analogy.
The kernel in a garden is the part of the plant that anchors it to the ground and distributes water and nutrients. In an operating system, the kernel provides essential services to applications and manages resources such as CPU time, memory, and disk space.	operating systems kernel	Explain operating systems kernel using a gardening analogy.
Just like a gardener needs to understand the soil, climate, and plants in order to grow a successful garden, an operating system kernel needs to understand the hardware, software, and users of a computer in order to run smoothly. The kernel is the core part of the operating system that interacts directly with the hardware and handles low-level tasks such as managing memory, scheduling tasks for execution, and handling I/O operations.	operating systems kernel	Explain operating systems kernel using a gardening analogy.
The kernel is the root of the operating system. It handles basic tasks such as managing memory, running programs, and handling hardware interrupts. Just as a gardener needs to take care of the roots of a plant in order for it to grow healthy and strong, an operating systems kernel must be well-maintained in order for an operating system to run smoothly.	operating systems kernel	Explain operating systems kernel using a gardening analogy.
The limiting reactant is the substance that's used up first in a chemical reaction. It's kind of like when you're gardening and you run out of plants to put in the ground. At that point, no more plants will grow, even if you add more soil.	limiting reactant	Explain limiting reactant using a gardening analogy.
A limiting reactant is the reactant in a chemical reaction that is present in the smallest amount. It determines how much of the other product can be formed. In gardening, if you have two pots of plants and one pot has twice as many plants as the other, then the plant population in the pot with fewer plants will eventually run out, even if there is an unlimited supply of water and soil. The same principle applies to chemical reactions - only so much product can be made based on how much of the limiting reactant is available.	limiting reactant	Explain limiting reactant using a gardening analogy.
A gardener has a certain amount of soil in their garden. They can add more soil, but only up to a certain point. After that, they will not be able to add any more soil no matter how much they want to. The same is true for reactants in a chemical reaction. There is a limit to the number of molecules that can participate in the reaction and after that limit is reached, no more molecules can join in no matter how much you might want them to. This limiting reactant determines how much product can be formed from the reaction.	limiting reactant	Explain limiting reactant using a gardening analogy.
Helicase is a protein that unwinds DNA. It can be thought of as a gardener who uses a hoe to break up the soil and then uses his hands to pull the weeds.	helicase	Explain helicase using a gardening analogy.
Helicase is the enzyme that unwinds DNA. It can be thought of as a gardener who uses a hoe to break up the soil and then uses their hands to pull the weeds. The helicase enzyme breaks up the double helix structure of DNA, making it easier for other enzymes to access and modify the genetic information.	helicase	Explain helicase using a gardening analogy.
Helicase is like a gardener who helps plants grow by winding up their vines. Helicase unwinds the DNA double helix so that the genetic information can be accessed and used to create new proteins.	helicase	Explain helicase using a gardening analogy.
DNA replication binding proteins are like the gardener who helps to prepare and plant the seeds, and then water and care for them as they grow. These proteins help to attach the new DNA strands to the existing chromosomes, ensuring that they are copied accurately.	dna replication binding proteins	Explain dna replication binding proteins using a gardening analogy.
DNA replication binding proteins are like gardeners who help to maintain the plants in the garden. They bind to specific places on the DNA molecule and help to keep it stable while the replication process occurs.	dna replication binding proteins	Explain dna replication binding proteins using a gardening analogy.
DNA replication binding proteins can be compared to gardening tools. They are necessary for the DNA molecule to be able to replicate and create new copies of itself. The protein binds to the DNA molecule and helps it move along, similar to how a shovel helps gardeners move dirt around. It also helps keep the DNA stable, much like how stakes hold up a garden hose.	dna replication binding proteins	Explain dna replication binding proteins using a gardening analogy.
A ligase is a garden tool used to attach two pieces of metal together. It works by heating the metals until they are soft, then using the ligase to press them together.	ligase	Explain ligase using a gardening analogy.
A ligase is a type of enzyme that helps to join two DNA strands together. This process is often referred to as "ligation." In gardening terms, you could think of ligases as the glue that helps hold plants together and keep them healthy.	ligase	Explain ligase using a gardening analogy.
A ligase is a protein that helps to join two DNA strands together. It can be thought of as the gardener who helps to attach new plants to an existing garden.	ligase	Explain ligase using a gardening analogy.
A process control block (PCB) is like a garden hose. The water pressure in the hose can be controlled by turning a valve on the faucet. The amount of water that comes out of the hose depends on how much water is let into the hose by the valve.	process control block	Explain process control block using a gardening analogy.
If you are trying to grow a garden, you need to water it and add fertilizer. The amount of water and fertilizer that you need depends on the size of your garden, the type of plants you are growing, and the climate. You also need to adjust these amounts as conditions change.A process control block is similar. It adjusts the amount of water and fertilizer depending on the conditions (the size of the factory, what type of product is being made, etc).	process control block	Explain process control block using a gardening analogy.
A process control block is like a gardener who waters plants at different intervals to make sure they don't die. The controller watches the process (the plants), and if it finds that the process isn't doing what it's supposed to be doing, it takes action (watering the plants).	process control block	Explain process control block using a gardening analogy.
When you plant a seed in the ground, you are encoding information about what type of plant you want to grow and where you want it to grow. The ground is the message delivery channel, and the seed is the encoded information. When water and sunlight reach the seed, it begins to grow into the plant that you encoded.	message encoding	Explain message encoding using a gardening analogy.
When you garden, you need to use the right tools for the job. message encoding is like using the right tool to get your message across.	message encoding	Explain message encoding using a gardening analogy.
The encoding of a message can be thought of as the way you package and label a gift for someone. The packaging is important because it protects the gift and also provides information about what is inside. The label on the package tells the person who receives the gift what it is, where it came from, and any other special instructions that might be included.	message encoding	Explain message encoding using a gardening analogy.
Drugs can be thought of as the plants, and receptor sites are the spots in the soil where they grow. When a drug attaches to a receptor site, it is like planting a seed in that spot. The more drugs that attach to a particular receptor site, the more crowded that spot becomes (just like when you have too many plants in one area of your garden, they start competing for resources). This competition can interfere with normal communication between cells, which can result in adverse effects.	interaction between drugs and receptor sites	Explain interaction between drugs and receptor sites using a gardening analogy.
Interaction between drugs and receptor sites can be thought of as a gardener tending to her plants. The gardener provides water, sunlight, and soil nutrients to the plants in order to help them grow. In the same way, drugs provide stimuli (e.g., chemical signals) to receptor sites in order to affect cellular function.	interaction between drugs and receptor sites	Explain interaction between drugs and receptor sites using a gardening analogy.
In gardening, plants rely on specific nutrients to grow and thrive. These nutrients are delivered to the plant's roots by way of the soil. The plant's roots can only absorb a certain amount of these nutrients at any one time, so there is competition among them for space and access to the root system. Just as different plants compete for soil nutrients, different drugs compete for receptor sites in order to produce their desired effect.	interaction between drugs and receptor sites	Explain interaction between drugs and receptor sites using a gardening analogy.
A monitor can be thought of as a garden hose. It is a conduit for delivering water to the plants in your garden. In the same way, a monitor is a conduit for delivering video and audio signals to your computer.	monitor	Explain monitor using a gardening analogy.
A monitor is like a garden hose. It's used to supply water to plants in the garden.	monitor	Explain monitor using a gardening analogy.
A monitor is like a gardener who waters and cares for plants. The monitor's job is to keep an eye on the screen and make sure that everything is running smoothly.	monitor	Explain monitor using a gardening analogy.
The CPU is like the gardener. It's responsible for watering the plants, weeding the garden, and making sure everything grows properly.	cpu	Explain cpu using a gardening analogy.
A CPU is like a gardener. It takes care of the plants in the garden, watering them and making sure they get enough sunlight.	cpu	Explain cpu using a gardening analogy.
A CPU is like a gardener. It helps to direct traffic and make sure everything runs smoothly.	cpu	Explain cpu using a gardening analogy.
A motherboard can be thought of as the root system of a garden. It is a large, flat piece of plastic or metal that sits at the bottom of the case and connects all of the different parts of the computer together. The motherboard contains slots for RAM modules, connectors for hard drives and optical drives, ports for connecting peripherals like mice and keyboards, and dozens of other components.	motherboard	Explain motherboard using a gardening analogy.
A motherboard can be thought of as the roots of a garden. The motherboard provides connections for all of the other parts of the computer (like the CPU, RAM, and graphics card), allowing them to communicate with each other.	motherboard	Explain motherboard using a gardening analogy.
Just as a motherboard is the foundation of a computer, a garden's mulch and soil are its foundation. Your plants' roots will grow down into the mulch and soil, spreading out to find water and nutrients. The plants will then send up shoots and leaves that spread out over the surface of the ground, taking in sunlight for photosynthesis. In much the same way, a motherboard provides pathways for electricity and data to flow through your computer, while also providing a base for mounting other components.	motherboard	Explain motherboard using a gardening analogy.
When you are planting a garden, you need to add compost or soil amendment to the hole before putting in the plant. The plant's roots will grow down and spread out in the new soil, taking up water and nutrients as they go. Ram works much the same way in a computer. When you add ram to your computer, it provides a place for the processor to store data that is currently being used. This makes your computer faster because it doesn't have to search through slower hard drive storage every time it needs to access that data again.	ram	Explain ram using a gardening analogy.
Ram is a gardening term for the male part of a flower. The ram's job is to transfer pollen from the stamen (male parts) to the pistil (female parts).	ram	Explain ram using a gardening analogy.
A ram is a male sheep. A gardener analogy for a ram could be that of a bull in a cattle yard. The ram would be the animal that mates with the cows, and the bulls are there to protect them from other males.	ram	Explain ram using a gardening analogy.
A power supply unit can be thought of as a water pump for a garden. Just like the pump supplies water to the plants in the garden, a power supply unit provides electricity to all of the components in a computer.	power supply unit	Explain power supply unit using a gardening analogy.
A power supply unit can be thought of as a hose that supplies water to a garden. The power supply unit provides electricity to the devices in the garden, just as the hose supplies water to plants and flowers.	power supply unit	Explain power supply unit using a gardening analogy.
A power supply unit in a garden analogy would be the water hose. The power supply unit provides power to the devices in the garden, just as the water hose supplies water to the plants.	power supply unit	Explain power supply unit using a gardening analogy.
The keyboard is like a shovel. It helps you to move the dirt (keys) around so that you can plant your flowers (type).	keyboard	Explain keyboard using a gardening analogy.
Just as a gardener needs a shovel to dig, a hoe to weed, and a rake to clean up leaves, a keyboard user needs keys to type letters, numbers, and symbols.	keyboard	Explain keyboard using a gardening analogy.
The keyboard is like a garden. The keys are the plants and the letters are the fruits and vegetables.	keyboard	Explain keyboard using a gardening analogy.
A mouse is like a weed in your garden. It's small and pesky, and it can be hard to get rid of.	mouse	Explain mouse using a gardening analogy.
A mouse is a small rodent that lives in the garden. They are very cute and playful, but can also be quite destructive. Mice love to eat seeds, fruits, and vegetables, as well as gnaw on plants and flowers.	mouse	Explain mouse using a gardening analogy.
A mouse is like a weed in your garden. It's small, pesky, and hard to get rid of.	mouse	Explain mouse using a gardening analogy.
A gardener might use an audio card to amplify the sound of a bird singing in a nearby tree. The audio card takes the sound from the bird and makes it louder so that the gardener can hear it more clearly.	audio card	Explain audio card using a gardening analogy.
An audio card can be analog or digital. Analog audio cards use a circuit to convert an electronic signal into an acoustic one, while digital audio cards use a codec to encode and decode an electronic signal into binary form so that it can be manipulated by a computer.	audio card	Explain audio card using a gardening analogy.
An audio card is a bit like the soil in your garden. It's what provides a foundation for your plants to grow on. In the same way, an audio card is what provides a foundation for your sound files to play on.	audio card	Explain audio card using a gardening analogy.
A video card is a bit like the fertilizer you use in your garden. It helps make things grow (in this analogy, that would be the pixels on your screen).	video card	Explain video card using a gardening analogy.
A video card is like a sprinkler system for your garden. It's what helps water and nourish the plants so they can grow big and strong.	video card	Explain video card using a gardening analogy.
A video card is like a watering can. It helps to give your plants (graphics) the right amount of water (information).	video card	Explain video card using a gardening analogy.
A tree's age calculation is similar to counting the number of years a gardener has been gardening. Just as with trees, each year that a gardener plants and cultivates flowers or vegetables counts as one year of experience. So, if someone started gardening at age 10 and continued until age 30, then they would have 20 years of experience.	tree's age calculation	Explain tree's age calculation using a gardening analogy.
A tree's age calculation is like counting the rings on a cut down tree trunk. Just like when you count the rings on a tree trunk, you can tell how old a tree is by counting its years.	tree's age calculation	Explain tree's age calculation using a gardening analogy.
A tree's age calculation is like counting the rings in a tree trunk. The number of rings indicates how many years have passed since the tree was planted.	tree's age calculation	Explain tree's age calculation using a gardening analogy.
If you think of sugar as a kind of food that plants eat, then glycolysis would be the process by which the plant breaks that food down into something it can use. Just as with any other kind of digestion, glycolysis splits sugar molecules into smaller pieces so they can be absorbed and used by the plant's cells.	glycolysis	Explain glycolysis using a gardening analogy.
In glycolysis, the gardener brings in soil and organic matter from outside to create a new garden bed. The gardener then digs small holes in the soil and plants seeds in each hole. As the plants grow, they use energy from the sun to convert carbon dioxide and water into carbohydrates (sugar) and oxygen. The sugar produced by the plants is used by the plant to grow larger and produce more flowers or fruit.	glycolysis	Explain glycolysis using a gardening analogy.
The process of glycolysis can be thought of as the breaking down of food into simple sugars in a garden. The gardener begins by placing food, such as fruits or vegetables, into a blender. The blender then chops up the food into small pieces that are easily digested. Next, the gardener pours water onto the chopped-up food and blends it together. This mixture is then poured into a large pot and boiled until the water evaporates, leaving behind simple sugars that can be absorbed by the plants.	glycolysis	Explain glycolysis using a gardening analogy.
If you are trying to water your garden, and you hold the hose up high and turn it on full blast, the water will shoot out of the hose in a powerful stream. However, if you point the hose at the ground and turn it on low, the water will slowly dribble out. This is because when the water hits something solid (like the ground), some of it gets reflected back towards the sky (anti-stokes scattering).	anti-stokes scattering	Explain anti-stokes scattering using a gardening analogy.
Anti-Stokes scattering can be best described by analogy to gardening. Imagine that you are trying to remove a weed from your garden. If you tug on the weed, it will resist being pulled out of the ground and will instead pull you towards it. This is analogous to the way that light resists being scattered in the opposite direction of its original travel. In contrast, if you try to dig around the weed to loosen it from the soil, it will come free more easily. This is analogous to how light is scattered when there is little resistance (such as in a vacuum).	anti-stokes scattering	Explain anti-stokes scattering using a gardening analogy.
If you are looking at a flower garden and someone walks in front of you, the flowers that were previously in focus now become blurry. This is because the person walking in front of you disrupted the light shining on the flowers. In a similar way, when light shines on a particle, it can be scattered by other particles nearby. This is known as anti-stokes scattering.	anti-stokes scattering	Explain anti-stokes scattering using a gardening analogy.
The scattering of light by small particles is similar to the scattering of raindrops by sunlight. In both cases, some light is reflected in all directions and some is transmitted through the medium.	stokes scattering	Explain stokes scattering using a gardening analogy.
When light shines on a leaf, the leaves scatter the light in all directions. The direction of the scattered light depends on how the leaf scatters the light. If you looked at a leaf from above, it would look like there was a random scattering of light happening on the surface of the leaf. But if you looked at it from below, you would see that most of the scattering is happening near to where the light is hitting the leaf. This is called stokes scattering because Sir George Gaspard Stokes first described this phenomenon mathematically in 1852.	stokes scattering	Explain stokes scattering using a gardening analogy.
When light shines on a leaf, some of the light is reflected directly back to our eyes. This is called specular reflection and it’s what makes leaves look shiny. But most of the light shining on a leaf scatters in all directions. Some of this scattered light reaches our eyes directly, while some bounces off other objects before reaching us. This type of scattering is called diffuse reflection.	stokes scattering	Explain stokes scattering using a gardening analogy.
A median lethal dose (LD) is the dose of a chemical that kills half of a tested population. In gardening, it would be like the amount of herbicide or insecticide needed to kill 50% of the plants.	median lethal dose	Explain median lethal dose using a gardening analogy.
The median lethal dose, or LD50, is the amount of a substance that will kill half of a group of test animals. In gardening terms, it would be the equivalent of putting half a teaspoon of pesticide into your garden's water supply; this would be enough to kill 50% of the plants.	median lethal dose	Explain median lethal dose using a gardening analogy.
A median lethal dose is the amount of a substance that will kill half of a population of test animals. In gardening, it might be said that the median lethal dose would be the amount of herbicide or pesticide necessary to kill 50% of the plants in an area.	median lethal dose	Explain median lethal dose using a gardening analogy.
The universe can be thought of as a garden. The Earth is the ground, the sun is the light, and the planets are the plants.	universe	Explain universe using a gardening analogy.
A gardener plants seeds in the ground. The sun shines on the seeds and they grow into plants. The plants drink water from the ground and use sunlight to make their own food.	universe	Explain universe using a gardening analogy.
The universe can be thought of as a garden. The earth is the ground, the sun is the light, and plants are the life.	universe	Explain universe using a gardening analogy.
The enzyme mechanism can be thought of as a gardener using a rake to move soil. The gardener is the enzyme, and the rake is the substrate. The gardener moves the rake back and forth over the soil, pushing it around. In the same way, the enzyme moves the substrate around, helping to create new molecules.	enzyme mechanism	Explain enzyme mechanism using a gardening analogy.
When a gardener wants to dig a hole in the ground, they use a shovel. The shovel is like an enzyme, and the ground is like the substrate. The gardener uses muscular energy to push down on the shovel, which then displaces soil from the hole. In much the same way, enzymes use kinetic energy to bind substrates and catalyze reactions.	enzyme mechanism	Explain enzyme mechanism using a gardening analogy.
The enzyme mechanism is like a gardener using a shovel to dig a hole. The shovel (enzyme) binds to the dirt (substrate) and starts digging. Once the hole is dug, the gardener can easily place the flower pot in the hole and fill in around it with soil. The substrate is like the dirt, and the enzyme is like the shovel.	enzyme mechanism	Explain enzyme mechanism using a gardening analogy.
A garden is filled with a variety of flowers. The gardener wants to know if the different colors of flowers make a difference in how often butterflies visit the garden. To answer this question, the gardener lays out three different gardens - one with all red flowers, one with all blue flowers, and one with a mix of both colors. Over time, the gardener observes how often butterflies visit each garden. The anova test would help to determine whether there is a statistical difference in the number of butterflies visiting each type of garden.	anova	Explain anova using a gardening analogy.
The analogy would be to think of the different types of plants in your garden as the levels of variation. The type of plant (e.g., rose, lily, daisy) is like the fixed factor, and the color of the flowers on each plant is like the random factor. The anova analysis would tell you whether there was a significant difference between the colors of roses and lilies, for example.	anova	Explain anova using a gardening analogy.
If you plant two different types of flowers in your garden and want to find out which type grows better, you could perform an ANOVA. The ANOVA would tell you whether the difference in growth between the two types of flowers is statistically significant.	anova	Explain anova using a gardening analogy.
A thermostat is a device used to control the temperature of a room or building. It does this by regulating the amount of heat that is allowed into the room or building. A gardening analogy would be to think of a thermostat as being like a sunflower. Sunflowers track the movement of the sun throughout the day and turn their heads so they are always facing the sun. This allows them to absorb more sunlight and produce more seeds. In much the same way, a thermostat regulates the amount of heat that enters a room or building so that the temperature remains consistent.	thermostat	Explain thermostat using a gardening analogy.
A thermostat is like a gardener who waters the garden when it needs water and stops watering when the plants have enough. The thermostat senses when the room temperature falls below or rises above the set point, and then runs or stops the furnace to bring the temperature back to the set point.	thermostat	Explain thermostat using a gardening analogy.
A thermostat is like a gardener who waters plants at certain times of the day to make sure they stay healthy. The thermostat regulates the temperature in your house so that you don't have to worry about it and can stay comfortable all year long.	thermostat	Explain thermostat using a gardening analogy.
Chemical equilibrium is a condition in which the rates of the forward and reverse chemical reactions are equal. In other words, it's a state where things aren't really happening one way or the other. It's like when your garden is in balance and you don't have to water it or weed it because everything is staying pretty much the same.	chemical equilibrium	Explain chemical equilibrium using a gardening analogy.
Chemical equilibrium is like a garden with two types of plants. The first type of plant (A) grows quickly and then dies, while the second type of plant (B) grows slowly but lasts for a long time. If you keep throwing more and more A plants into the garden, eventually there will be more A plants than B plants. However, if you leave the garden alone, eventually the number of A and B plants will become equal again. This is because both types of plants are competing for sunlight, water, and other resources, and as one type starts to dominate, the other type starts to die off.	chemical equilibrium	Explain chemical equilibrium using a gardening analogy.
Chemical equilibrium can be thought of as a garden where different plants are growing in close proximity. Over time, the various plants will start to compete for sunlight, water, and nutrients. The taller plants will shade the shorter plants, and the less vigorous plants will eventually die out. However, if you were to periodically trim back the taller plants, then more light would reach the shorter plants and they would thrive. In a similar way, chemical equilibrium is maintained when competing reactions occur at equal rates. If one reaction starts to predominate, then it will "trim back" the other reaction until both are occurring at equal rates again.	chemical equilibrium	Explain chemical equilibrium using a gardening analogy.
In gardening, just-in-time might mean watering the plants only when they need it. By using this approach, you avoid wasting water on plants that don't need it and you ensure that the plants that do need water get the right amount. In business, just-in-time refers to a manufacturing philosophy where materials and parts are delivered to the factory floor only as they are needed in order to minimize waste and inventory costs.	just-in-time	Explain just-in-time using a gardening analogy.
The gardening analogy for just-in-time is like having a garden where you only plant the vegetables you need for that day. You're not wasting any space by planting vegetables that you won't be able to use, and you're not overplanting either. This is similar to how just-in-time works in manufacturing. It's efficient because it doesn't produce more than what's needed and it reduces waste.	just-in-time	Explain just-in-time using a gardening analogy.
In a gardening analogy, just-in-time would be like having a large stockpile of seeds in your garage. You only plant as many seeds as you need for the current season and store the rest away. This way you don't have to worry about running out of seeds during the planting season.	just-in-time	Explain just-in-time using a gardening analogy.
Adaptive immunity is like a gardener who plants seeds, waters them, and then watches them grow. The gardener protects the plants from pests and diseases, and when they are big enough, the gardener harvests them.	adaptive immunity	Explain adaptive immunity using a gardening analogy.
In adaptive immunity, the body's immune system "remembers" previous infections and is better able to fight off future infections from the same organism. This analogy uses a gardener as an example of how adaptive immunity works.The gardener plants seeds in the ground and waters them. The seeds grow into plants, which produce flowers and fruit. The gardener then collects the fruit and stores it in her pantry. Later, when she gets sick with a cold, she eats some of the fruit from her garden. Because she has eaten the fruit before, her body recognizes the virus in the fruit and is better able to fight off the virus inside her own body.	adaptive immunity	Explain adaptive immunity using a gardening analogy.
Adaptive immunity can be thought of as a gardener watering her plants. The gardener provides water when the soil is dry and stops watering when the soil is wet. In this way, she adapts her watering to the needs of the plants. Analogously, adaptive immunity responds to specific threats by producing antibodies that attack and neutralize those threats.	adaptive immunity	Explain adaptive immunity using a gardening analogy.
In gardening, water flow is analogous to electric current, and the diameter of the hose (or pipe) is analogous to the resistance. The pressure of the water (or voltage) is analogous to the electrical potential difference, and the amount of water flowing through the hose (or amperage) is analogous to the electrical current.	ohm's law	Explain ohm's law using a gardening analogy.
If you want to water your plants evenly, you can use a garden hose with multiple spray nozzles. Each nozzle will release the same amount of water per minute. You can think of each nozzle as an ohm (the amount of resistance) and the garden hose as the voltage. The more nozzles you have on your hose, the more current (amperage) will flow through it.	ohm's law	Explain ohm's law using a gardening analogy.
When you water your plants, the amount of water (current) that comes out of the hose is determined by how far open the valve is (voltage). The more open the valve, the more water flows. The size of the hose (resistance) also affects how much water flows. If you have a small hose with low resistance, it will flow more quickly than if you have a big hose with high resistance.	ohm's law	Explain ohm's law using a gardening analogy.
Transcription is the process of copying DNA to make RNA. Just as a gardener might take a cutting from one plant and root it in another to create a new plant, transcription copies genetic information from one part of the DNA molecule to another area in RNA.	transcription	Explain transcription using a gardening analogy.
Transcription is the process of copying a gene's DNA sequence so that it can be used to produce a protein. This analogy uses gardening as an example: imagine you have a beautiful garden with many different types of flowers. To keep your garden looking its best, you might want to copy the genes for each type of flower so you can plant more of them. Transcription is like making a copy of the instructions for growing each type of flower, so you can use those instructions to grow more flowers in your garden.	transcription	Explain transcription using a gardening analogy.
Transcription is the process of copying DNA to make RNA. This analogy uses gardening as an example. Transcription is like when you take a clipping from a plant and put it in water so that it will grow into another plant. The original plant (DNA) provides the instructions for making a new copy of itself (RNA).	transcription	Explain transcription using a gardening analogy.
RNA polymerase can be thought of as a gardener. Just like a gardener plants seeds and nurtures them until they grow into flowers or vegetables, RNA polymerase helps to plant the genetic instructions for making proteins and then oversees their growth and development.	rna polymerase	Explain rna polymerase using a gardening analogy.
RNA polymerase is a enzyme that helps to create new strands of DNA. It can be thought of as a gardener who plants the seeds and watering them, helping them grow into strong plants. In the same way, RNA polymerase helps to create new strands of DNA by attaching nucleotides together.	rna polymerase	Explain rna polymerase using a gardening analogy.
RNA polymerase can be thought of as a gardener. It is responsible for planting the seeds (nucleotides) and watering them so that they grow into RNA molecules.	rna polymerase	Explain rna polymerase using a gardening analogy.
The ribosome is like a gardener. It takes the instructions from the DNA (the blueprint) and creates new proteins (the plants).	ribosome	Explain ribosome using a gardening analogy.
Ribosomes are like the gardeners who plant the seeds and water them. The plants that grow from the seeds are the proteins.	ribosome	Explain ribosome using a gardening analogy.
Ribosomes are like the gardener who plants and waters the seeds, then watches them grow into plants. The ribosomes help to create new proteins by reading the instructions that are found within a gene.	ribosome	Explain ribosome using a gardening analogy.
One analogy for activator protein is that it is like a gardener who waters the plants and makes sure they have enough sunlight. The activator protein helps to turn on the genes that are responsible for making new proteins.	activator protein	Explain activator protein using a gardening analogy.
An activator protein is like a gardener. It helps to activate or turn on genes that are responsible for specific tasks in the cell, such as producing proteins.	activator protein	Explain activator protein using a gardening analogy.
The activator protein is like a gardener who helps plants grow by providing them with water and fertilizer. The activator protein helps the promoter region of a gene to function, which in turn allows the gene to be expressed (or turned on).	activator protein	Explain activator protein using a gardening analogy.
Electric current is like water flowing through a garden hose. Just as the more water you have in the hose, the faster it will flow, so too does electric current increase with voltage. The amount of electric current in a circuit is measured in amperes (amps), just like the amount of water flowing through a hose is measured in gallons per minute.	electric circuit	Explain electric circuit using a gardening analogy.
In a garden, the plants are connected to the soil by their roots. The plants can then take in water and minerals from the soil. In an electric circuit, the wires are like the plant's roots. The battery is like the watering can, providing water (electricity) to the circuit. The light bulb is like the plant, using electricity from the battery to turn on.	electric circuit	Explain electric circuit using a gardening analogy.
Electric circuits can be thought of as gardens. Current is like water flowing through the garden hose. Voltage is like the pressure of the water in the hose. Resistance is like how easily the water flows through different parts of the garden hose (e.g., wider part, narrower part, kink in hose). The more resistance there is, the harder it will be for current to flow through that section of the circuit.	electric circuit	Explain electric circuit using a gardening analogy.
In gardening, water is essential to help plants grow. However, if you were to submerge a garden hose in a bucket of water, the water would slowly leak out from the hose because it is hydrophilic. In order to stop the leakage, you can coat the outside of the hose with petroleum jelly (a hydrophobic substance) and this will create a barrier between the water and the hose so that less water will be lost. The same principle applies when substances are placed in contact with each other in an aqueous environment: those that are hydrophobic will try to avoid contact with those that are hydrophilic.	hydrophobic effect	Explain hydrophobic effect using a gardening analogy.
If you have ever tried to water a cactus, you know that it is difficult to get the water to penetrate the plant's defenses. The same thing happens with hydrophobic molecules. Hydrophobic molecules do not like water and will try to avoid it by hiding in non-polar environments where water cannot reach them. This effect is sometimes called the "water hating" or "hydrophobic" effect.	hydrophobic effect	Explain hydrophobic effect using a gardening analogy.
Water is attracted to other water molecules and will naturally flow towards them, which is why it's so easy for us to get dehydrated. Plants rely on water to transport nutrients up their stems and distribute them throughout their leaves, but hydrophobic chemicals don't like being around all that H2O. So they cluster together in small pockets within the plant, making it harder for water to move through the tissue. This effect is called hydrophobic or "water-fearing" because these chemicals are repelled by water.	hydrophobic effect	Explain hydrophobic effect using a gardening analogy.
When you water your plants, the water is a signal that tells the plant to grow. The plant absorbs the water through its roots and then uses it to power its growth. In a similar way, when a protein kinase receives a signal from outside the cell, it sends a message to other proteins inside the cell telling them what to do.	biological signal transduction	Explain biological signal transduction using a gardening analogy.
The gardener analogy for signal transduction is as follows: In the garden, a watering can with a spout is used to direct water where it is needed. The same principle applies in cells; messages are transmitted from one area of the cell to another by means of proteins that act as channels or gates. Just as the gardener can control the flow of water from the watering can, so too do proteins regulate the flow of ions and other molecules across cell membranes, enabling communication between different parts of the cell.	biological signal transduction	Explain biological signal transduction using a gardening analogy.
In general, signal transduction refers to the process by which a signal is transmitted from one point in a cell to another. This can be thought of as similar to how water travels through a garden hose. The pressure of the water (the signal) causes it to flow through the hose until it reaches the end, where it sprays out. In cells, various proteins act as receptors that sit on the surface and detect incoming signals. When they do, they trigger a series of reactions inside the cell that ultimately lead to a change in its behavior.	biological signal transduction	Explain biological signal transduction using a gardening analogy.
