Nadh is the artist's equivalent to a paintbrush. It is responsible for bringing energy to the cells and enabling them to create ATP. Without nadh, the cells would be unable to produce energy and create art.	nadh	Using an arts analogy, explain nadh.
Nadh is like the paintbrush used by an artist. It is not the painting, but it helps to create the masterpiece. Nadh is necessary for energy production in the body and without it, we would be unable to function.	nadh	Using an arts analogy, explain nadh.
Nadh is like the paints an artist uses to create a painting. It is necessary for the creation of energy in the body, and it is also responsible for transporting carbon dioxide out of the cells.	nadh	Using an arts analogy, explain nadh.
In the same way that an artist's palette consists of a range of colors that can be combined to create different hues, proteins are made up of smaller molecules called amino acids. By linking together different combinations of these amino acids, proteins can form long chains with a variety of shapes and functions. Just as an artist might use varying shades and textures to create a painting, proteins carry out many different tasks in the body by using their unique structure.	proteins	Using an arts analogy, explain proteins.
Proteins are like the paint on an artist's canvas. They give cells their structure and allow them to carry out their functions. Proteins also interact with other molecules in the cell, including DNA, to control how the cell grows and divides.	proteins	Using an arts analogy, explain proteins.
Proteins are like the paint on a canvas. They provide color, texture, and shape to the cell.	proteins	Using an arts analogy, explain proteins.
DNA is similar to a painting. The paint on the canvas is like the DNA sequence, and the colors and strokes are like the genetic code. Just as a painter can create different paintings with different looks and feels, so too can nature produce multiple versions of an organism by altering its DNA sequence.	dna	Using an arts analogy, explain dna.
DNA is the foundation of all life. It is a molecule that contains the genetic instructions used in the development and functioning of all living organisms. DNA is a long, thin molecule made up of two strands that wrap around each other to form a spiral staircase-like shape. The sequence of nucleotides on these strands determines everything from an organism's physical characteristics to its susceptibility to disease.	dna	Using an arts analogy, explain dna.
DNA is the blueprint of a particular species. It is like the score for an opera- it tells the cells how to build everything that makes up that organism, from its hair to its heart.	dna	Using an arts analogy, explain dna.
Glycogen is the "fuel" that powers the muscles. It is a type of carbohydrate that is stored in the muscles and liver. When you exercise, your body uses glycogen to provide energy for the muscles.	glycogen	Using an arts analogy, explain glycogen.
Glycogen is the "paint" that an artist uses to create a painting. Just as an artist needs paint to create a painting, a runner needs glycogen to create energy for running. Glycogen is stored in the muscles and liver, and it is used to produce energy during exercise.	glycogen	Using an arts analogy, explain glycogen.
Glycogen is a storage molecule for glucose in the body. It is made up of chains of glucose molecules and can be found in the liver and muscles. Glycogen is used to provide energy for the body, especially during periods of high activity. When blood sugar levels are low, glycogen breaks down into individual glucose molecules to raise blood sugar levels.	glycogen	Using an arts analogy, explain glycogen.
Endoplasmic Reticulum is like the backstage crew for a theater production. They do all of the behind-the-scenes work to make sure everything runs smoothly and looks good on stage. The ER helps create and process proteins, which are essential for cell function.	endoplasmic reticulum	Using an arts analogy, explain endoplasmic reticulum.
Endoplasmic reticulum is like the canvas for an artist. It provides a surface on which proteins can be synthesized and folded.	endoplasmic reticulum	Using an arts analogy, explain endoplasmic reticulum.
Endoplasmic reticulum is the equivalent of a theater stage. It's where all the action happens - it's where proteins are synthesized and folded, lipids are made, and where calcium ions are stored. The endoplasmic reticulum also helps to detoxify the cell by breaking down toxins.	endoplasmic reticulum	Using an arts analogy, explain endoplasmic reticulum.
Golgi is the stage in cell development immediately following the endoplasmic reticulum. It is responsible for packaging proteins into vesicles that will be transported to other parts of the cell.	golgi	Using an arts analogy, explain golgi.
The Golgi apparatus helps to package and ship proteins out of the cell. It is analogous to an art studio, where artists produce paintings and sculptures. The Golgi apparatus takes newly made proteins and wraps them in a membrane, creating tiny sacs called vesicles. These vesicles are then released from the cell and travel to other parts of the body where they deliver their cargo.	golgi	Using an arts analogy, explain golgi.
Golgi is like the art teacher in school. He/she oversees the creation of art, making sure each student's work meets a certain standard. Golgi helps to create and package proteins that will be sent to different parts of the cell.	golgi	Using an arts analogy, explain golgi.
The plasma membrane is like the canvas for an artist. The artist can use this surface to create their masterpiece. The cells in our body are like the artists, and the plasma membrane is their medium. The cells use the plasma membrane to interact with their environment and communicate with other cells.	plasma membrane	Using an arts analogy, explain plasma membrane.
The plasma membrane is like the canvas on an artist's easel. The proteins and lipids that make up the membrane are like the paint and brushes that the artist uses to create a work of art. Just as different colors can be used to create different images, different proteins and lipids can be used to create different membranes with unique properties.	plasma membrane	Using an arts analogy, explain plasma membrane.
The plasma membrane is like the canvas on an artist's easel. It is the surface on which all of the action happens, and it provides a boundary between what's inside and outside of the cell. The plasma membrane is made up of a thin layer of proteins and lipids that surround the cell, and it allows things to move in and out while keeping everything else inside.	plasma membrane	Using an arts analogy, explain plasma membrane.
Lysosomes are like the digestive system of a cell. They break down large molecules into smaller pieces that the cell can use for energy or to build new molecules.	lysosome	Using an arts analogy, explain lysosome.
Lysosomes are like the recycling bins of cells. They recycle cellular waste products and help to keep the cell clean. Lysosomes also play a role in cell signaling, which is how cells communicate with one another.	lysosome	Using an arts analogy, explain lysosome.
The lysosome is the “artist’s studio” of the cell. It is a small, round organelle that is responsible for breaking down large molecules into smaller pieces. This process is called digestion and it allows the cell to recycle old or damaged proteins, lipids, and nucleic acids. The lysosome also helps to regulate the amount of these materials in the cell.	lysosome	Using an arts analogy, explain lysosome.
Peroxisomes are like a theater. The nucleus is the director and the organelles are the actors. The peroxisomes control what type of play is being performed, while the nucleus decides which actors will be in each scene.	peroxisomes	Using an arts analogy, explain peroxisomes.
Peroxisomes are like the paintbrushes of a painter. They allow the artist to add color and detail to their work. In much the same way, peroxisomes help cells perform specific functions by adding chemicals (like oxygen) to other molecules.	peroxisomes	Using an arts analogy, explain peroxisomes.
Peroxisomes are like a black box theatre. They are small and unassuming, but they play an important role in the production of the show. In the case of peroxisomes, this show is made up of chemicals that help keep us healthy. Peroxisomes produce hydrogen peroxide, which can kill harmful bacteria and viruses.	peroxisomes	Using an arts analogy, explain peroxisomes.
Mitochondria are the "engines" of our cells - they produce the energy that our cells need to function. They do this by breaking down food molecules into smaller pieces that can be used by the cell, and then using that energy to create adenosine triphosphate (ATP), which is basically a cellular currency that all cells use to pay for things like building new proteins or transporting molecules across membranes.	mitochondria	Using an arts analogy, explain mitochondria.
Mitochondria are the cells that produce energy in our bodies. Just as an artist needs a canvas and paints to create a work of art, mitochondria need oxygen and food to create energy.	mitochondria	Using an arts analogy, explain mitochondria.
Mitochondria are like the stage crew for a play. They set up and take down the scenery, make sure all of the props are in place, and help to keep everything running smoothly during the performance. In other words, they provide energy and support to all of the other cells in the body.	mitochondria	Using an arts analogy, explain mitochondria.
Chloroplasts are organelles in the plant cell that are unique in that they have the ability to change light into chemical energy that can be used by plants to create glucose from carbon dioxide and water. In other words, chloroplasts are responsible for photosynthesis.	chloroplast	Using an arts analogy, explain chloroplast.
Chloroplast is an organelle found in the cytoplasm of photosynthetic cells. It is a small, round, discoid structure that is about 1-3 micrometers in diameter. Chloroplasts are unique in that they have two membrane systems: the outer and inner membranes. The outer membrane surrounds the chloroplast while the inner membrane forms numerous folds or sacs called thylakoids. The thylakoids are where light energy is converted into chemical energy by photosynthesis	chloroplast	Using an arts analogy, explain chloroplast.
Chloroplasts are organelles in the plant cell that are unique in that they have the ability to change sunlight into chemical energy that can be used by plants to create glucose from carbon dioxide and water.	chloroplast	Using an arts analogy, explain chloroplast.
The cytoskeleton is like the scaffolding of a building. It helps to support and shape the cell while also allowing it to move around.	cytoskeleton	Using an arts analogy, explain cytoskeleton.
Cytoskeleton is the backbone of a structure. In an art piece, it would be the frame and supports that keep everything in place. The cytoskeleton does the same for cells, keeping their shape and internal organization intact. It also helps them move around and attach to other cells or surfaces.	cytoskeleton	Using an arts analogy, explain cytoskeleton.
The cytoskeleton is like the skeleton of a human. It provides support to the cell and helps it maintain its shape. The cytoskeleton also plays a role in cell movement and division.	cytoskeleton	Using an arts analogy, explain cytoskeleton.
ATP is the currency of energy in cells. It is used to power everything from movement and thinking to cell division and protein synthesis. ATP molecules are made when one carbon atom from glucose combines with three oxygen atoms, releasing energy that can be used by the cell. The process of making ATP is called respiration, and it takes place in the mitochondria, tiny organelles inside cells.	atp	Using an arts analogy, explain atp.
ATP is the currency of energy in the body. Just as money can be used to buy goods and services, ATP is used to purchase energy needed for all bodily functions.	atp	Using an arts analogy, explain atp.
ATP is the currency of energy in the body. It is used to power everything from muscle contraction during exercise to neuron firing in the brain. Muscles use ATP for short-term bursts of energy, while the brain uses it for long-term activity.	atp	Using an arts analogy, explain atp.
NADPH is a cofactor that helps the artist create her work. It is necessary for the production of many important molecules in the body, including cholesterol and proteins.	nadph	Using an arts analogy, explain nadph.
Nadph is like the red paint that artists use to add color to their paintings. It's a vital part of the creative process, and it helps make everything look more vibrant and alive.	nadph	Using an arts analogy, explain nadph.
Nadph (nicotinamide adenine dinucleotide phosphate) is a cofactor that helps enzymes convert energy from food into useful forms for the body. It is similar to ADP (adenine dinucleotide phosphate), which also helps with this process, but NADPH has an extra phosphate group that makes it better at converting energy.	nadph	Using an arts analogy, explain nadph.
Peroxysomes are like the art galleries of the cell. Just as an art gallery contains paintings and sculptures by different artists, peroxysomes contain a variety of enzymes that help the cell to break down food, detoxify pollutants and fight infections.	peroxysome	Using an arts analogy, explain peroxysome.
Peroxysomes are like the art studios of cells. They're where a lot of the creative work happens, including the production of important enzymes.	peroxysome	Using an arts analogy, explain peroxysome.
Peroxysomes are like the art galleries of cells. They contain beautiful and important works of art (enzymes) that allow the cell to function properly.	peroxysome	Using an arts analogy, explain peroxysome.
Mytochondria are the cells that make up the muscle tissue in our bodies. They are responsible for repairing and building new muscle tissue, as well as producing energy for muscles to use during activity. Just like an artist's palette is used to create a painting, mytochondria are used by our bodies to create muscle tissue.	mytochondria	Using an arts analogy, explain mytochondria.
Mytochondria are the cells in an organism that produce energy. They are similar to the artist who creates the paintings or drawings that make up an art exhibit. The mytochondria create energy within the cells of the organism, much like how an artist creates a work of art.	mytochondria	Using an arts analogy, explain mytochondria.
Mytochondria are the cells in your body that produce energy. Think of them as the artist who creates the painting. The mytochondria use oxygen and glucose to create energy, which is then used by all of the other cells in your body.	mytochondria	Using an arts analogy, explain mytochondria.
Electric forces can be thought of as analogous to the gravitational force between masses. Just as masses pull on each other with a gravitational force, charges exert an electric force on each other. Unlike gravity, however, the electric force gets weaker as the distance between the charges increases.	electric forces	Using an arts analogy, explain electric forces.
Electric forces are the equivalent of artist's brushes. They allow particles to interact with each other, and create the electric force field that surrounds them.	electric forces	Using an arts analogy, explain electric forces.
Electric forces are the equivalent of magnets. Like magnets, electric charges can exert a force on each other that pulls them together or pushes them apart. Unlike magnets, electric charges can be either positive or negative.	electric forces	Using an arts analogy, explain electric forces.
The orbital of a hydrogen electron is similar to the orbit of a planet around the sun. The electron moves in an elliptical path around the nucleus, with the highest point of its orbit being closest to the nucleus.	hydrogen electron's orbital	Using an arts analogy, explain hydrogen electron's orbital.
An electron's orbital can be thought of as a artist's canvas. The size and shape of the orbital is determined by how much energy the electron has. The more energy an electron has, the larger its orbital will be.	hydrogen electron's orbital	Using an arts analogy, explain hydrogen electron's orbital.
An electron in an atom occupies a particular space called an orbital. The shape of each orbital is determined by the energy of the electron and can hold a certain number of electrons. Orbitals are further divided into subshells, which are designated by letters (s, p, d, f). The hydrogen atom has one proton in the nucleus and one electron orbiting around it. The electron's orbital is described as "1s." This means that the electron is in the first subshell (s) and its orbital has the shape of a spheres with its center at the nucleus.	hydrogen electron's orbital	Using an arts analogy, explain hydrogen electron's orbital.
The first line of defense is the skin. The skin is a barrier that keeps bad things out of the body and good things in.	first line of defense in the body	Using an arts analogy, explain first line of defense in the body.
The first line of defense in the body is made up of skin, mucous membranes, and hair. These barriers help keep out bacteria, viruses, and other foreign substances.	first line of defense in the body	Using an arts analogy, explain first line of defense in the body.
The first line of defense in the body is made up of different types of cells that make up the skin. The skin contains a number of different cells that work together to protect the body from infection and other foreign invaders. These cells include macrophages, neutrophils, natural killer cells, and dendritic cells.	first line of defense in the body	Using an arts analogy, explain first line of defense in the body.
Macrophages are like the janitors of the body. They clean up bacteria, dead cells, and other debris.	macrophages	Using an arts analogy, explain macrophages.
Macrophages are like the janitors or security guards of the immune system. They patrol the body and clean up any debris or pathogens that they find. They also secrete cytokines which help to activate other cells of the immune system.	macrophages	Using an arts analogy, explain macrophages.
Macrophages are like the stage crew for an arts performance. They set up and take down the props, help with costumes, and make sure everything runs smoothly behind the scenes. In the body, macrophages help to clear away debris, fight infection, and keep things running smoothly.	macrophages	Using an arts analogy, explain macrophages.
T-helper cells are the Picassos of the immune system. They help orchestrate the actions of other cells to mount a coordinated response against an invader.	t-helper cells	Using an arts analogy, explain t-helper cells.
T-helper cells are like the directors of an orchestra. They help orchestrate the activities of other immune system cells to fight infection.	t-helper cells	Using an arts analogy, explain t-helper cells.
T-helper cells are the "artist" of the immune system. They help orchestrate and direct the activity of other cells, like "musicians," to fight off infection or disease. T-helper cells also produce important proteins called cytokines, which help regulate the overall immune response.	t-helper cells	Using an arts analogy, explain t-helper cells.
B-lymphocytes are like the painters of the immune system. They use their knowledge of the body to create specific antibodies that can bind to and neutralize foreign invaders.	b-lymphocytes	Using an arts analogy, explain b-lymphocytes.
B-lymphocytes are like the painters in an art studio. They use their creativity and skills to produce new molecules called antibodies. These antibodies help protect the body from infection.	b-lymphocytes	Using an arts analogy, explain b-lymphocytes.
B-lymphocytes are like the directors of an orchestra. They help orchestrate the activities of other cells in order to fight infection.	b-lymphocytes	Using an arts analogy, explain b-lymphocytes.
Cytotoxic T-lymphocytes are like the "policemen" of the immune system. They patrol the body for cells that are not supposed to be there, such as cancer cells or virus-infected cells, and they destroy them.	cytotoxic t-lymphocytes	Using an arts analogy, explain cytotoxic t-lymphocytes.
Cytotoxic T-lymphocytes are white blood cells that help the body fight infection. They identify and destroy foreign cells, including bacteria, viruses, and cancer cells.	cytotoxic t-lymphocytes	Using an arts analogy, explain cytotoxic t-lymphocytes.
Cytotoxic T-lymphocytes are like the painters of the immune system. They survey the body for cells that look different or strange, and then they destroy them.	cytotoxic t-lymphocytes	Using an arts analogy, explain cytotoxic t-lymphocytes.
Bacteria invade by entering the body through a break in the skin, such as a cut or scrape. Once inside the body, they can travel to other parts of the body and cause infection.	invasion of bacterias	Using an arts analogy, explain invasion of bacterias.
When bacteria invade a person's body, they are like artists invading a new canvas. They can spread quickly and cause damage to the tissues surrounding them. Just as an artist might create beautiful or exciting works of art on a new canvas, bacteria can cause harm (or even death) when they invade a new host.	invasion of bacterias	Using an arts analogy, explain invasion of bacterias.
Bacteria are like an invading army, coming in and taking over the cells. They use up all of the resources inside the cell, and can even kill the cell in the process. This is what causes infection and illness.	invasion of bacterias	Using an arts analogy, explain invasion of bacterias.
When you go to a museum, you may see paintings with beautiful colors. The colors are not really there; instead, they are the result of light reflecting off of the paint. This is because different colors reflect different amounts of light. Red reflects more than blue, so when red and blue paint mix together, you see purple.This is similar to how an action potential works in your brain. When a neuron fires, it sends out a signal in the form of electricity. This electricity travels down the neuron until it reaches the end where it causes the release of neurotransmitters. These neurotransmitters stimulate other neurons, which then send out their own signals.	action potential	Using an arts analogy, explain action potential.
An action potential is like a wave of energy that travels down an arts organization's hierarchy. This wave starts with the board, who pass it on to the executive director, and then down to the staff. Each person in the organization is responsible for enacting this energy by taking action and creating work.	action potential	Using an arts analogy, explain action potential.
An action potential can be thought of as an artist's brushstroke. Just as the artist's hand movements control the direction and width of each stroke, electrical signals traveling through a neuron control the movement of ions across its membrane. This determines whether or not potassium or sodium ions are allowed to enter the neuron, which in turn creates an electric current that travels down the nerve fiber. The strength of this current is what ultimately generates an action potential.	action potential	Using an arts analogy, explain action potential.
The experiment of chromatography is similar to an artist using different colors of paint to create a painting. The artist starts with a white canvas and adds different colors, layer by layer, to create the desired image. In the same way, chromatography uses different colors (or molecules) of ink to create a separation of substances in a liquid mixture.	experiment of chromatography	Using an arts analogy, explain experiment of chromatography.
Chromatography is the experiment of separating a mixture into its individual parts. In this analogy, think of the different colors in a rainbow. Each color is a different component that makes up the whole (the rainbow). Chromatography is similar to this because it separates each color (component) so that they can be studied individually.	experiment of chromatography	Using an arts analogy, explain experiment of chromatography.
Chromatography is the experiment of separating colors. The different colors are placed on a piece of paper and then water is poured over it. The different colors will dissolve in the water at different rates and will be able to be separated by how quickly they dissolve.	experiment of chromatography	Using an arts analogy, explain experiment of chromatography.
Stars are much like people in that they have a life cycle. A star is born from a nebula, or cloud of gas and dust. The star's mass determines how long it will live on the main sequence. Most stars, like the sun, live for billions of years while burning hydrogen into helium. When the star runs out of hydrogen to burn, it expands into a red giant and eventually dies.	main-sequence lifetimes of stars	Using an arts analogy, explain main-sequence lifetimes of stars.
Stars will spend most of their lifetime as a main sequence star. This is when the star is using nuclear fusion to create energy, and it is in equilibrium between the force of gravity trying to collapse the star and the pressure from thermonuclear fusion pushing outward. The main sequence lifetime for a star depends on its mass - more massive stars have shorter lifetimes than less massive stars.	main-sequence lifetimes of stars	Using an arts analogy, explain main-sequence lifetimes of stars.
The main sequence lifetime of a star is the amount of time it spends burning hydrogen in its core. The longer a star spends on the main sequence, the more massive it is.	main-sequence lifetimes of stars	Using an arts analogy, explain main-sequence lifetimes of stars.
Nucleus is the center of an atom. It contains the protons and neutrons that make up the atom's mass.	nucleus	Using an arts analogy, explain nucleus.
The nucleus is like the director of a play. He or she oversees everything that goes on and makes sure it all runs smoothly.	nucleus	Using an arts analogy, explain nucleus.
The nucleus of an atom is the central, positively charged core. It contains most of the atoms' mass and all of its protons. The electrons orbit around it in shells.	nucleus	Using an arts analogy, explain nucleus.
Ribosomes are the cells that produce proteins. They look like small beads and are found in the cytoplasm of all cells. The ribosomes reads the genetic code in a gene and produces a specific protein according to that code.	ribosomes	Using an arts analogy, explain ribosomes.
Ribosomes are the "engines" of protein synthesis. They are small, round organelles that can be found in the cytoplasm of all cells. Ribosomes consist of two subunits: a large subunit and a small subunit. The large subunit is responsible for decoding the genetic information in mRNA molecules and assembling the proteins encoded by those genes. The small subunit helps to assemble the proteins and peptides produced by the ribosome.	ribosomes	Using an arts analogy, explain ribosomes.
Ribosomes are the little factories in our cells that produce all of the proteins we need. Just as an artist has a studio where they create their art, ribosomes have a special place inside of our cells where they make proteins.	ribosomes	Using an arts analogy, explain ribosomes.
The Golgi apparatus is like an artist's studio. It is where the cell processes and packages proteins that are created in the ribosomes.	golgi apparatus	Using an arts analogy, explain golgi apparatus.
Golgi apparatus is like a museum curator. It takes the products of the endoplasmic reticulum and packages them into small vesicles that it sends to other parts of the cell.	golgi apparatus	Using an arts analogy, explain golgi apparatus.
The golgi apparatus is like a frame for a painting. The painter can put the paint on the canvas and then use the frame to hold everything in place while it dries. The golgi apparatus helps proteins to be made and delivered to their correct destination inside of a cell.	golgi apparatus	Using an arts analogy, explain golgi apparatus.
Lysosomes are like the stomachs of cells. They digest food and break down waste products.	lysosomes	Using an arts analogy, explain lysosomes.
Lysosomes are like the artists' studios in a gallery. They are little rooms where the artist can work on their art without being disturbed. Lysosomes are small sacs inside cells that store enzymes. These enzymes break down large molecules into smaller ones, so the cell can use them for energy or to build new proteins.	lysosomes	Using an arts analogy, explain lysosomes.
Lysosomes are like the recycling bin of a cell. They digest and break down old or damaged proteins, lipids, and nucleic acids into their component parts. These components can then be recycled to build new molecules for the cell.	lysosomes	Using an arts analogy, explain lysosomes.
Just as an artist's canvas is the surface on which they create their artwork, the nuclear envelope is a membrane that surrounds the nucleus of a cell. This membrane helps to protect the genetic material within the nucleus while also controlling what enters and leaves.	nuclear envelope	Using an arts analogy, explain nuclear envelope.
Nuclear envelope is the protective outer layer of a nucleus. It is made up of two lipid bilayers, which enclose the DNA and proteins that make up the nucleus. The nuclear envelope helps to protect the genetic information inside the nucleus from damage, and it also helps to control what enters and leaves the nucleus.	nuclear envelope	Using an arts analogy, explain nuclear envelope.
The nuclear envelope is like the frame of a painting. It surrounds and supports the nuclear material inside the cell. The nuclear envelope is made up of two membranes, called the inner and outer nuclear membrane. These membranes work together to control what goes in and out of the nucleus.	nuclear envelope	Using an arts analogy, explain nuclear envelope.
A vacuole is like an empty space in a painting. It's an area that doesn't have any color or detail.	vacuoles	Using an arts analogy, explain vacuoles.
In an analogy to the arts, vacuoles can be thought of as empty spaces or areas within a work of art. These spaces may be used for storage, or they may simply be left empty to create visual interest. Similarly, in cells, vacuoles are used for storage or disposal and can play an important role in the health and functioning of the cell.	vacuoles	Using an arts analogy, explain vacuoles.
A vacuole is a space in the cytoplasm of a cell that is filled with fluid or gas. It helps to store food, water, and other materials.	vacuoles	Using an arts analogy, explain vacuoles.
Cytoplasm is the fluid that fills up a cell and contains all of the organelles. It's kind of like the paint in an artist's palette - it's what they use to create their work.	cytoplasm	Using an arts analogy, explain cytoplasm.
Cytoplasm can be seen as the paint and canvas of a painting. It is the foundation that everything else is built on top of. In paintings, you often have different colors and textures that are used to create an image. Cytoplasm performs a similar function in cells; it contains different organelles that allow the cell to perform various functions.	cytoplasm	Using an arts analogy, explain cytoplasm.
Cytoplasm is the substance of a cell between the plasma membrane and the nucleus. Cytoplasm contains organelles, including mitochondria, which produce energy for the cell, and ribosomes, which produce proteins.	cytoplasm	Using an arts analogy, explain cytoplasm.
Chromosomes are the colors used in a painting. They are responsible for the different shades and hues that make up an image. In the same way, chromosomes control all of the different aspects of gene expression - from color to size to shape.	chromosome	Using an arts analogy, explain chromosome.
Chromosomes are the threads that make up the fabric of our genes. They are like the individual strings in a woven tapestry, or the different colors of paint on a canvas. Chromosomes carry all of the genetic information needed to create and sustain life.	chromosome	Using an arts analogy, explain chromosome.
Chromosomes are like the canvas on which genes are painted. Genes are like the colors that make up the painting.	chromosome	Using an arts analogy, explain chromosome.
Cytosol is the water-based solution in which organelles and other cell structures float. It is a complex mixture of proteins, lipids, salts, and metabolites that provide the cells with the necessary nutrients and energy to function.	cytosol	Using an arts analogy, explain cytosol.
Cytosol is the water-based solution in which organelles and other cell structures float. It consists of about 80% water, 10-15% proteins, and 2-5% lipids.	cytosol	Using an arts analogy, explain cytosol.
The cytosol is the substance that fills the cell and surrounds the organelles. Just as paint is used to color a picture on canvas, cytosol provides color and nutrients to cells. It also helps transport materials in and out of cells.	cytosol	Using an arts analogy, explain cytosol.
A cell is like an artist's canvas. The cell can be filled with different colors, or proteins, that dictate what the cell will become.	cell	Using an arts analogy, explain cell.
A cell is like a canvas that an artist can use to create a masterpiece. The artist has many colors and tools at their disposal to make the painting come to life. Similarly, the cell has many molecules and proteins that it can use to carry out its functions.	cell	Using an arts analogy, explain cell.
A cell is like a canvas that an artist can use to create a painting. The artist can use different colors and techniques to create a masterpiece. In the same way, cells can be used to create tissues and organs.	cell	Using an arts analogy, explain cell.
Paintings are created by applying paint to a canvas. The paint is stored in small containers called vesicles. When the artist wants to use a particular color, she opens a vesicle and squeezes the paint onto the canvas.	vesicles	Using an arts analogy, explain vesicles.
In biology, a vesicle is a small structure within a cell that has a specific function. Vesicles can be either organic or inorganic. In organic vesicles, the membrane enclosing the contents is made of lipid and protein. In inorganic vesicles, the membrane is made of inorganic materials such as metals or ceramics.	vesicles	Using an arts analogy, explain vesicles.
A vesicle is a small sac-like structure that forms within the cytoplasm of a cell. Vesicles are used to store and transport cellular materials such as proteins, lipids, and nucleic acids.	vesicles	Using an arts analogy, explain vesicles.
The cell wall is like the frame of a painting. It provides structure and support to the cells while also protecting them from outside forces.	cell wall	Using an arts analogy, explain cell wall.
The cell wall is like a canvas that the painter uses to create their painting. The cell wall is what gives the cells their shape and also helps to protect them from outside forces.	cell wall	Using an arts analogy, explain cell wall.
Cell wall is like the frame of a painting. It provides structure and support to the cell while also protecting it from damage.	cell wall	Using an arts analogy, explain cell wall.
Cells can be thought of as the basic unit of structure and function in living things. Just like an artist might use different colors, shapes, and sizes to create a masterpiece, cells use different molecules to carry out specific tasks within the cell.	cells	Using an arts analogy, explain cells.
Cells are the basic building blocks of all living things. Just as an artist uses different colors and shapes to create a work of art, cells use various proteins and molecules to create everything from tissues to entire organisms.	cells	Using an arts analogy, explain cells.
Cells are the building blocks of all living things. Just as an artist uses different colors and shapes to create a masterpiece, cells use different molecules to create everything from a simple virus to a complex human being.	cells	Using an arts analogy, explain cells.
A cell membrane is like an artist's canvas. Just as an artist can use different colors and techniques to create a masterpiece, the cell membrane can use different molecules to create a barrier that controls what enters and leaves the cell.	cell membrane	Using an arts analogy, explain cell membrane.
The cell membrane is like a painting. It is the boundary that separates what is inside the cell from what is outside the cell. The cell membrane controls what enters and leaves the cell, just as an artist controls what goes into and comes out of their painting.	cell membrane	Using an arts analogy, explain cell membrane.
Just as an artist has a canvas on which to paint, cells have a membrane that serves as their "canvas" - it's the outer boundary of the cell and is responsible for keeping things in or out. The cell membrane is made up of two layers of phospholipids (fatty molecules) with proteins embedded in it, and this structure allows it to be both flexible and strong. The proteins allow different substances to move in and out of the cell while maintaining the overall balance of fluids inside and outside the cell.	cell membrane	Using an arts analogy, explain cell membrane.
Golgi body is like an artist's workshop. It is where new proteins are made and packaged for use in the cell.	golgi body	Using an arts analogy, explain golgi body.
The Golgi body is the final step in protein processing. It modifies and packages proteins into small sacs called vesicles. These vesicles are then sent to other parts of the cell, or even to different cells, where they release their contents.	golgi body	Using an arts analogy, explain golgi body.
The Golgi body is a bit like an art gallery. It's a place where unfinished works of art are stored and processed until they're ready to be displayed in the public eye. In the same way, the Golgi body stores and processes proteins until they're ready to be used by the cell.	golgi body	Using an arts analogy, explain golgi body.
A capacitor is like a container of water. The more water there is in the container, the more capacitance it has. Just as with an electrical circuit, adding capacitance to a system will help store energy and regulate current flow.	capacitance	Using an arts analogy, explain capacitance.
Capacitance is a measure of how much electrical charge can be stored in an object. It is measured in farads (F). Capacitors are used to store energy and release it when needed.	capacitance	Using an arts analogy, explain capacitance.
A capacitor is a device used to store electric energy in an electric field. It consists of two conducting plates separated by a nonconducting material, called the dielectric. The greater the separation between the plates and the higher the voltage applied to them, the more capacitance they will have. Capacitors are usually measured in Farads.	capacitance	Using an arts analogy, explain capacitance.
Electric current is like a river of electricity that flows through wires. It can power lights and appliances, and it can also be dangerous if you're not careful.	electric current	Using an arts analogy, explain electric current.
Electric current is much like the flow of water in a river. Just as the amount and direction of the water's flow can be used to power machines, electric current can be harnessed to do work. In both cases, there must be a continuous source of energy (the sun or a dam) to keep things moving.	electric current	Using an arts analogy, explain electric current.
Electric current is the flow of electricity. Just as water flows through a river, electric current flows through a wire. The faster the water flows, the stronger the current will be.	electric current	Using an arts analogy, explain electric current.
Just as an artist's canvas or sketchbook is blank until it's filled with color and form, a circuit's voltage is zero until electrical current begins to flow. Voltage is the "pressure" that causes electricity to move through a conductor (like metal wires), making lights glow, motors spin, and all sorts of devices do their thing.	voltage	Using an arts analogy, explain voltage.
Voltage is the difference in electrical potential between two points. It is what makes current flow, and it can be likened to water pressure. Just as a higher water pressure will cause more water to flow through a pipe than a lower pressure, a greater voltage will cause more current to flow through an electrical circuit.	voltage	Using an arts analogy, explain voltage.
The voltage is the difference in electrical potential between two points. It is what causes current to flow through a circuit.	voltage	Using an arts analogy, explain voltage.
In a cell, communication is the process that allows different parts of the cell to share information with each other. This communication can be in the form of chemical signals, or it can be through physical contact between different parts of the cell. Specialization refers to the fact that different parts of the cell have specific functions, and they rely on communication to carry out these functions.	specialization and communication in a cell	Using an arts analogy, explain specialization and communication in a cell.
In an art class, a student may specialize in painting, while another specializes in sculpture. Both students will likely be able to communicate with each other about their work, and even collaborate on projects. However, they are not expected to be experts in the other person's field of study. In the same way, cells specialize in different tasks such as secreting enzymes or taking up oxygen from the air. However, all cells must be able to communicate with each other in order to coordinate activities and maintain cellular health.	specialization and communication in a cell	Using an arts analogy, explain specialization and communication in a cell.
A musician who specializes in playing the cello is able to communicate with other musicians through their mutual understanding of music. Cells specialize in different tasks, such as secreting proteins or taking in nutrients, and they are able to communicate with one another through chemical signals. These signals allow cells to coordinate their activities and respond to changes in the environment.	specialization and communication in a cell	Using an arts analogy, explain specialization and communication in a cell.
Kirchoff's voltage law is similar to the way a composer arranges notes on a sheet of music. Just as the composer must ensure that all the notes played together create a harmonious sound, so too must electrical engineers ensure that all of the voltages in an electrical circuit are in balance.	kirchoff's voltage law	Using an arts analogy, explain kirchoff's voltage law.
In electrical engineering, Kirchhoff's voltage law (KVL) is a statement of the principle that the sum of the voltages around any closed loop in an electrical circuit is zero.	kirchoff's voltage law	Using an arts analogy, explain kirchoff's voltage law.
Kirchhoff's Voltage Law states that the algebraic sum of all voltages in a closed loop is zero. This means that the voltage at any point in a circuit is equal to the sum of the voltages of all the components connected to it.	kirchoff's voltage law	Using an arts analogy, explain kirchoff's voltage law.
A density wave is like a soundwave that travels through the air. It starts out as a small disturbance and then gets bigger and bigger until it reaches its peak. After that, it slowly dies down until it disappears completely.	nature of a density wave	Using an arts analogy, explain nature of a density wave.
A density wave is like a crowd of people moving through a room. The people are all moving at the same speed and in the same direction.	nature of a density wave	Using an arts analogy, explain nature of a density wave.
A density wave can be thought of as a traveling ripple or vibration in a medium. It is an oscillation of the number of particles per unit volume. The wave moves through the medium, pushing and pulling on the particles as it goes.	nature of a density wave	Using an arts analogy, explain nature of a density wave.
Enzymes are like the paint brushes of the cell. They allow the cells to interact with their environment and create new molecules. Enzymes are very specific in what they do, so each one has a different job to do in the cell.	enzymes	Using an arts analogy, explain enzymes.
Enzymes are like the paint and canvas of a painting. The enzymes provide the structure and catalyze the chemical reactions, while the substrate is the paint that is used to create the image.	enzymes	Using an arts analogy, explain enzymes.
Enzymes are like the paintbrushes and easels of the cell. They are responsible for creating and shaping proteins, which are the building blocks of life. Enzymes can be found in all living things and they play a crucial role in almost every biochemical process that occurs within cells.	enzymes	Using an arts analogy, explain enzymes.
The human active memory system can be compared to an artist's palette. The artist has a variety of colors to choose from and can mix them together to create new shades. In the same way, our memories are made up of different bits and pieces that we can combine and recombine in different ways.	human active memory system	Using an arts analogy, explain human active memory system.
The human active memory system can be thought of as an artist's studio. The artist has a variety of paints, brushes, and other tools at her disposal. She can select the colors and instruments she needs to create her masterpiece. Similarly, the human brain has many different regions that allow it to store memories. The hippocampus is like the artist's palette; it contains many different colors and flavors of memory. Other parts of the brain act like paintbrushes, allowing us to access our memories whenever we need them.	human active memory system	Using an arts analogy, explain human active memory system.
Just as an artist has a canvas on which to create a work of art, the human active memory system provides a space for individuals to store and recall information. The artist's canvas is blank until they begin creating their artwork using various tools - such as paintbrushes, pencils, or charcoal. Similarly, the human active memory system is inactive until individuals begin storing and recalling information. This can be done by utilizing different encoding strategies - such as verbalizing new information or picturing it in your mind's eye. Once encoded, this information can be stored in short-term memory (the "canvas"), where it can be accessed and used briefly. If needed, this information can then be transferred to long-term memory (the "art gallery"), where it will be stored permanently.	human active memory system	Using an arts analogy, explain human active memory system.
The rate-determining step of a reaction is the slowest step in the overall reaction. This means that it is the step that determines how fast the reaction will proceed.	rate-determining step of a reaction	Using an arts analogy, explain rate-determining step of a reaction.
The rate-determining step of a reaction is the slowest step in the overall reaction. The rate of a reaction is determined by how quickly this slowest step can occur.	rate-determining step of a reaction	Using an arts analogy, explain rate-determining step of a reaction.
The rate-determining step of a reaction is the slowest step in the overall reaction. This step determines how quickly the entire reaction will take place.	rate-determining step of a reaction	Using an arts analogy, explain rate-determining step of a reaction.
Column chromatography is like an artist using a paintbrush to paint a picture. The artist starts with a blank canvas and dips the brush into some paint. He or she then starts painting the picture by making strokes with the brush. The more strokes that are made, the darker the painting becomes. Column chromatography works in a similar way. A sample is placed in a column, and then a solvent is slowly added to it. Gradually, the components of the sample start to move through the column and become separated from each other. The moresolvent that is added,the further apart the components become.	column chromatography	Using an arts analogy, explain column chromatography.
Column chromatography separates compounds by their relative affinities for a stationary phase (a solid or liquid) and a mobile phase (a liquid). In column chromatography, the stationary phase is packed into a narrow tube or column. The mobile phase is then passed through the column, allowing the different compounds to be separated based on how strongly they are attracted to each of the two phases.	column chromatography	Using an arts analogy, explain column chromatography.
Column chromatography is like a giant easel with many, many tubes of paint in different colors. It is used to separate mixtures into their individual components. The mixture is put into the top of the column and then a solvent (the paint) is slowly poured down over it. The various compounds in the mixture will travel at different speeds through the column, depending on how soluble they are in the solvent. At the bottom of the column there is a collection tube where each component can be collected separately.	column chromatography	Using an arts analogy, explain column chromatography.
Dynamic chemical equilibrium is the state in which a reaction occurs at the same rate as it is reversed, so that there is no net change in concentration of the reactants or products.	dynamic chemical equilibrium	Using an arts analogy, explain dynamic chemical equilibrium.
Dynamic chemical equilibrium is like a painting that is always in flux, but at any given point the painting looks complete. The individual molecules are constantly moving about, but at any given moment they are all in the right place and it appears to be static.	dynamic chemical equilibrium	Using an arts analogy, explain dynamic chemical equilibrium.
Dynamic chemical equilibrium is like a song that has been played so many times that the notes are no longer distinguishable from one another. The molecules in a system at dynamic equilibrium have reached a point where they are no longer moving around and changing their positions.	dynamic chemical equilibrium	Using an arts analogy, explain dynamic chemical equilibrium.
A vacuole is a small, membrane-bound sac that forms in the cytoplasm of cells. It is filled with water or other substances and helps to maintain the shape of the cell.	vacuole	Using an arts analogy, explain vacuole.
A vacuole is like an artist's canvas. It is a space where the artist can put their ideas and thoughts. The artist can use the canvas to create new works of art or to change old ones.	vacuole	Using an arts analogy, explain vacuole.
A vacuole is like an artist's palette. It is a container of paints that the artist can use to create a work of art. The colors on the palette are mixed together to create new colors. In the same way, the contents of the vacuole are mixed together to create new substances.	vacuole	Using an arts analogy, explain vacuole.
An analogy for transport vesicles would be an artist's canvas and paint. The canvas is the transport vesicle, and the paint is the cargo being transported. just as an artist uses a canvas to apply paint to create a work of art, cells use transport vesicles to shuttle cargo (such as proteins) around their interior.	transport vesicles	Using an arts analogy, explain transport vesicles.
Transport vesicles are like an artist's canvas - they provide a surface on which cargo can be transported. The cargo is carried within the transport vesicle and then released when the vesicle reaches its destination.	transport vesicles	Using an arts analogy, explain transport vesicles.
One way to think about transport vesicles is to analogy them to a bus. The cell membrane is the curb and the proteins on the surface of the membrane are the stop signs. The vesicle is like a bus that stops at each protein, picks up its passengers (molecules), and then continues on its way until it reaches its final destination (another protein).	transport vesicles	Using an arts analogy, explain transport vesicles.
Proto-oncogenes are like the painters of a painting. They can make beautiful things, but if they go too far, they can also create something ugly. proto-oncogenes are normal genes that can become cancerous if they are mutated and start to produce too much protein.	proto-oncogenes	Using an arts analogy, explain proto-oncogenes.
Proto-oncogenes are like the directors of an arts organization. They direct the activities of other genes and help to control when and how cells grow and divide. proto-oncogenes can become oncogenes if they mutate and start to cause cancerous growths.	proto-oncogenes	Using an arts analogy, explain proto-oncogenes.
Proto-oncogenes are like the directors of a play. They tell other genes when to turn on and off, and they help control how cells grow and divide. Normally, proto-oncogenes keep cell growth under control. But if something goes wrong and these genes become mutated, they can start telling cells to grow out of control, leading to cancer.	proto-oncogenes	Using an arts analogy, explain proto-oncogenes.
Oncogenes are genes that can cause cancer. They are sometimes called proto-oncogenes because they can become oncogenes if they are mutated.	oncogenes	Using an arts analogy, explain oncogenes.
Oncogenes are like the conductor of an orchestra. They're responsible for telling the cells when to grow and divide. But sometimes, oncogenes can go a little too crazy, leading to cancerous growths.	oncogenes	Using an arts analogy, explain oncogenes.
An oncogene is like a musician in a symphony orchestra. The musician has the ability to make beautiful music, but if something goes wrong, they can also cause chaos. Oncogenes are genes that have the potential to cause cancer when they're mutated or expressed at high levels.	oncogenes	Using an arts analogy, explain oncogenes.
Just as an artist might use a variety of colors and techniques to create a painting, tumor suppressor genes work together to keep cells functioning normally. They help to prevent tumors from forming by stopping cells from growing and dividing too quickly or in an uncontrolled way.	tumor suppressor genes	Using an arts analogy, explain tumor suppressor genes.
If you think of genes as the instruments in an orchestra, then tumor suppressor genes would be the conductor. They make sure all the other genes are working together and doing their jobs properly. If something goes wrong and a gene starts to act out of control, the tumor suppressor gene can step in and stop it.	tumor suppressor genes	Using an arts analogy, explain tumor suppressor genes.
Tumor suppressor genes are like the brakes on a car. They help to keep cells from growing and dividing too quickly or in an uncontrolled way, which can lead to cancer.	tumor suppressor genes	Using an arts analogy, explain tumor suppressor genes.
Software can be seen as an art form - it's created with a specific goal in mind, and takes time and effort to perfect. However, just like any other type of art, software can also be brittle. This means that it's easily broken or damaged, and doesn't respond well to changes or new demands. In order to make software less brittle, you need to put in extra time and effort to ensure that it's flexibility and durability are both high.	brittle software	Using an arts analogy, explain brittle software.
The software is brittle if a small change in one part of the system causes a large change in another part of the system. The system is not very flexible, and it is difficult to make changes without causing problems.	brittle software	Using an arts analogy, explain brittle software.
If software is compared to a ceramic vase, then brittle software would be one that could easily shatter or break into pieces with very little force. This is generally not desirable in software as it can lead to unexpected and difficult-to-debug errors.	brittle software	Using an arts analogy, explain brittle software.
If you think of atoms as guitar strings, and the electron shells as different notes on those strings, then you can see how resonance hybridization works. When two or more electrons occupy the same energy level (ie. they are playing the same note on the string), they will hybridize together to create a new resonant note. This is what happens in molecules with multiple double bonds - all of the electrons involved in making those double bonds end up sharing the same energy level, so they all hybridize together to create one big resonance hybrid molecule.	resonance hybrid	Using an arts analogy, explain resonance hybrid.
In an analogy with arts, resonance hybrid can be seen as a type of sculpture. It is made by taking several pieces of metal or other materials and welding them together. The welds are then ground down so that the different pieces blend seamlessly into one another. This creates a new object that is stronger than any of the individual components. In the same way, resonance hybridization occurs when two or more atomic orbitals merge to form a new orbital with properties that are not found in any of the original orbitals.	resonance hybrid	Using an arts analogy, explain resonance hybrid.
In physics, resonance hybrid is an atomic or molecular orbital description of a chemical bond in which two or more electron orbitals are combined to form one larger orbital. This results in a lower energy for the system as a whole.	resonance hybrid	Using an arts analogy, explain resonance hybrid.
In wave mechanics, each particle in a medium vibrates about its equilibrium position. This vibration creates a series of waves that travel through the medium. The speed at which these waves travel is determined by the elasticity and density of the medium.	wave mechanical model	Using an arts analogy, explain wave mechanical model.
One way to think of a wave mechanical model is as an artist's canvas. The model consists of rows and columns of squares, with each square representing a particle. The particles are connected by springs, and the waves propagate through the system by traveling along the springs.	wave mechanical model	Using an arts analogy, explain wave mechanical model.
The wave mechanical model is similar to waves in a pond. The energy of the wave travels through the water, and as it moves along, it causes the surface of the water to move up and down. This movement creates small ripples that spread out from where the wave started. In much the same way, waves of energy travel through atoms and molecules, causing them to vibrate. These vibrations create tiny packets of energy called quanta, which are responsible for the light and heat we see and feel.	wave mechanical model	Using an arts analogy, explain wave mechanical model.
An electroencephalogram, or EEG, is a measure of the electrical activity in your brain. Just like an ECG measures the electrical activity of your heart, an EEG measures the electrical activity of your brain. This test can help doctors see if you have any problems with your brain function.	electroencephalogram	Using an arts analogy, explain electroencephalogram.
An electroencephalogram is an image of the brain's electrical activity. It records the rhythmic firing of neurons in the brain.	electroencephalogram	Using an arts analogy, explain electroencephalogram.
An electroencephalogram, or EEG, is like a map of the brain's electrical activity. It records the tiny voltage changes that occur when brain cells communicate with each other.	electroencephalogram	Using an arts analogy, explain electroencephalogram.
DNA replication is like a painter creating a duplicate of a painting. The painter takes the original painting and copies it, creating an identical copy. DNA replication works in a similar way. The genetic information in DNA is copied, resulting in two identical strands of DNA.	dna replication	Using an arts analogy, explain dna replication.
DNA replication can be thought of as an artist creating a duplicate of his or her work. The original piece is the DNA, and the copy is the RNA.	dna replication	Using an arts analogy, explain dna replication.
DNA replication is like a painter copying a painting. The painter takes the original painting and makes a copy of it by using the same colors, strokes, and techniques. DNA replication works in a similar way; the genetic information in DNA is copied so that each new cell has its own set of instructions.	dna replication	Using an arts analogy, explain dna replication.
Just as an author writes a story and a musician composes music, RNA transcription is the process of creating new RNA molecules from DNA templates. This involves reading the genetic code in the DNA sequence and assembling the corresponding RNA molecule.	rna transcription	Using an arts analogy, explain rna transcription.
Rna transcription is similar to an artist transferring a picture from one medium to another. The artist starts with a blank canvas and uses paint to create the image. The rna molecule is like the canvas and the genetic information is like the image. The rna polymerase enzyme is like the painter, it creates new rna molecules by copying the genetic information from DNA.	rna transcription	Using an arts analogy, explain rna transcription.
Just as a musician needs sheet music to play a song, the genetic instructions for making proteins are stored in DNA. To make a protein, the information encoded in DNA is first transcribed into RNA (ribonucleic acid). The RNA molecule then serves as a template for assembling the protein.	rna transcription	Using an arts analogy, explain rna transcription.
The protein translation process can be thought of as an artist painting a picture. The artist begins with a blank canvas and selects the colors they will use to create their masterpiece. In the same way, the cellular machinery involved in protein synthesis starts with an empty space called a mRNA template. This template is used to select the correct amino acids that will form the new protein molecule. Like an artist mixing different colors together on their palette, these amino acids are brought together and linked to form the new protein chain.	protein translation	Using an arts analogy, explain protein translation.
The process of translating a protein from its DNA sequence into the corresponding amino acid sequence is analogous to an artist taking a picture with a camera. The genetic code (the DNA) is like the photographic negative, and each set of three nucleotides (codons) corresponds to one specific amino acid. During translation, ribosomes "read" the codons on the mRNA molecule and use them as instructions to build a protein chain.	protein translation	Using an arts analogy, explain protein translation.
The process of protein translation can be thought of as an orchestra playing a symphony. The musicians (the proteins) are reading the sheet music (the genetic code) and playing their parts accordingly. The conductor (the ribosome) is ensuring that everything runs smoothly and on time.	protein translation	Using an arts analogy, explain protein translation.
In ecology, an ecosystem is a community of living organisms and their physical environment.	ecosystem	Using an arts analogy, explain ecosystem.
An ecosystem is a community of different species of living organisms and their physical environment. The term can be used to refer to any unit that comprises a community of interacting organisms and their physical environment, including marine ecosystems, forest ecosystems, and agroecosystems.	ecosystem	Using an arts analogy, explain ecosystem.
An ecosystem is like an orchestra. The different instruments (species) all work together to create a beautiful symphony (balance). If one of the instruments is missing or playing out of tune, it can ruin the whole performance.	ecosystem	Using an arts analogy, explain ecosystem.
A musician might use the analogy of a guitarist plucking a string on her guitar. As she plucks the string, it vibrates and causes neighboring strings to vibrate as well. This is called propagation of sound waves. In much the same way, an action potential travels down a neuron by causing adjacent neurons to fire as well.	propagation of an action potential down a neuron	Using an arts analogy, explain propagation of an action potential down a neuron.
When an action potential is initiated at the axon hillock, it travels down the neuron in a process called saltatory conduction. This occurs because voltage-sensitive sodium channels open and allow positively charged Na+ ions to flow into the neuron. This creates an electrical current that propagates down the neuron. The influx of Na+ ions also causes the membrane potential to become more positive (depolarized), which in turn opens more voltage-sensitive sodium channels. This positive feedback loop increases the speed of propagation until it reaches the terminal buttons, where it triggers neurotransmitter release.	propagation of an action potential down a neuron	Using an arts analogy, explain propagation of an action potential down a neuron.
Action potentials are similar to sound waves. They start at one point and spread out until they reach the end of the neuron.	propagation of an action potential down a neuron	Using an arts analogy, explain propagation of an action potential down a neuron.
The breathing mechanism of frogs is similar to that of humans. Air enters the body through the nose and mouth, travels down the throat, and into the lungs. From there, it oxygenates the blood and is circulated throughout the body.	breathing mechanism of frogs	Using an arts analogy, explain breathing mechanism of frogs.
When you breathe in, your lungs expand and take in air. The air travels down your throat and into your windpipe. The windpipe branches off into two tubes called bronchi, which lead to your lungs. Frogs have the same breathing mechanism as humans.	breathing mechanism of frogs	Using an arts analogy, explain breathing mechanism of frogs.
A frog's breathing mechanism is similar to that of a human. Air enters the body through the nose and mouth, travels down the throat into the lungs, and then exits through the ribcage. Frogs have a special way of breathing though; they can also take in air through their skin. This allows them to breathe even when their head is submerged underwater	breathing mechanism of frogs	Using an arts analogy, explain breathing mechanism of frogs.
The use of layers in architecture is similar to the way paint is applied to a canvas. The first layer, or primer, covers the surface and prepares it for the next layer. This might be a coat of white paint to create a blank canvas or a base color that will show through the top layers. The second layer is usually thicker and more colorful than the first. It might be an image of flowers overlaid on a green background or brightly colored stripes. Finally, the topmost layer provides details like shadows and highlights. A painting with multiple layers looks richer and more complex than one with just one color or brushstroke.	layered architecture	Using an arts analogy, explain layered architecture.
Like an onion, a layered architecture features multiple layers that can be peeled away one at a time. Each layer in the system serves a specific purpose and provides functionality to the higher-level layers above it. This modularity allows for greater flexibility and easier modification of the system as a whole.	layered architecture	Using an arts analogy, explain layered architecture.
An analogy for layered architecture would be like the different layers of paint on a canvas. The first layer is the base, and each additional layer is applied on top of the previous one. Each layer can be seen and affects the final outcome of the painting.	layered architecture	Using an arts analogy, explain layered architecture.
A limiting reactant is a substance that limits the amount of product that can be formed in a chemical reaction. The other reactants are called excess reactants.	limiting reactant and excess reactant	Using an arts analogy, explain limiting reactant and excess reactant.
A limiting reactant is the substance in a chemical reaction that limits the amount of product that can be formed. The excess reactant is the other substance in the reaction that's not used up by the time the limiting reactant is gone.	limiting reactant and excess reactant	Using an arts analogy, explain limiting reactant and excess reactant.
A limiting reactant is the one that's used up first in a chemical reaction. The excess reactant is the one that's leftover.	limiting reactant and excess reactant	Using an arts analogy, explain limiting reactant and excess reactant.
A eukaryotic cell is like an orchestra. Each musician has their own part to play, but they all work together to create a beautiful piece of music. Eukaryotic cells are made up of smaller units called organelles, which each have their own specific function. The organelles work together to keep the cell alive and functioning.	eukaryotic cell	Using an arts analogy, explain eukaryotic cell.
The eukaryotic cell is like an orchestra. It has many different parts that work together to create something beautiful. The nucleus is the conductor, and it tells the other parts what to do. The mitochondria are like the musicians, and they create the music. The cytoplasm is like the audience, and it listens to the music and enjoys it.	eukaryotic cell	Using an arts analogy, explain eukaryotic cell.
Eukaryotic cells are like paintings because they have a lot of different colors and textures. Prokaryotic cells are more like sketches because they are mostly one color and don't have as many details.	eukaryotic cell	Using an arts analogy, explain eukaryotic cell.
The prokaryotic cell is like the canvas for an artist. It provides a basic structure that the artist can work with to create something new. In the same way, the prokaryotic cell provides a basic structure for proteins and other molecules to interact with one another and carry out important processes.	prokaryotic cell	Using an arts analogy, explain prokaryotic cell.
A prokaryotic cell is like an artist's canvas. The canvas provides a surface on which the artist can create their work. Likewise, a prokaryotic cell provides a surface on which genetic material can be expressed and proteins can be synthesized.	prokaryotic cell	Using an arts analogy, explain prokaryotic cell.
A prokaryotic cell is like a canvas that an artist can use to create any type of artwork they desire. The artist has complete control over the canvas and can paint whatever they want on it. In the same way, a prokaryotic cell can be used to create any type of protein or molecule that is needed.	prokaryotic cell	Using an arts analogy, explain prokaryotic cell.
An operating system kernel is like the engine of a car. It's responsible for managing the resources of the computer and providing basic services to the applications that run on it.	operating systems kernel	Using an arts analogy, explain operating systems kernel.
The kernel is the engine of an arts organization. It provides the basic structure and functionality that allows everything else to work. The kernel determines how much money the organization has to spend, what kind of art it can make or support, and how it will be structured.	operating systems kernel	Using an arts analogy, explain operating systems kernel.
The kernel is the engine of a car. It's responsible for turning fuel into motion, and without it the car would just sit there. The same is true for an operating system - the kernel takes input from programs and drivers and turns it into output that the computer can understand.	operating systems kernel	Using an arts analogy, explain operating systems kernel.
A limiting reactant is a chemical that limits the amount of product that can be formed in a reaction. It is the substance that is completely used up first, and therefore determines how much of the other product can be made.	limiting reactant	Using an arts analogy, explain limiting reactant.
A limiting reactant is the reactant in a chemical reaction that controls how much product can be formed. The other reactants in the reaction will continue to combine until they all combine with the limiting reactant.	limiting reactant	Using an arts analogy, explain limiting reactant.
When you are making a painting, you might start with a white canvas. You can add different colors to the canvas, but if you keep adding more and more color it will eventually become too dark and the picture won't be very pretty. In the same way, when you are reacting chemicals together there is only so much space for them to occupy. If you add more of one chemical than the other, then the first one will run out and the reaction will stop. This is called a limiting reactant.	limiting reactant	Using an arts analogy, explain limiting reactant.
Helicase is the enzyme that unwinds and separates the two DNA strands. It does this by binding to the DNA molecule and then using its motor to literally spin it apart.	helicase	Using an arts analogy, explain helicase.
If you think of the helicase enzyme as a "spinning wheel" it can help to understand its role in replication. The helicase enzyme unwinds the DNA double helix so that each strand can be used as a template for replication.	helicase	Using an arts analogy, explain helicase.
Helicase is the enzyme responsible for unzipping the DNA double helix, making it possible for new genetic information to be copied. It works by unwinding one strand of DNA at a time and separating the nucleotides so that they can be replicated.	helicase	Using an arts analogy, explain helicase.
DNA replication binding proteins are like the directors of an opera. They help to make sure everything runs smoothly and that all the pieces fit together properly.	dna replication binding proteins	Using an arts analogy, explain dna replication binding proteins.
In replication, the binding proteins attach to specific regions of DNA called promoters. They help organize and stabilize the replication machinery as it assembles on the DNA molecule. The proteins also play a role in ensuring that only one copy of each gene is made during replication.	dna replication binding proteins	Using an arts analogy, explain dna replication binding proteins.
Dna replication binding proteins are like the art restorers of the dna world. Just as an artist's original painting may be harmed over time, so too can the dna molecule itself become damaged. The job of the replication binding protein is to help mend any breaks in the dna helix and keep things running smoothly so that accurate copies can be made.	dna replication binding proteins	Using an arts analogy, explain dna replication binding proteins.
Ligase is the enzyme that joins two DNA strands together.	ligase	Using an arts analogy, explain ligase.
Ligase is the enzyme that joins two DNA strands together. It catalyzes the formation of a phosphodiester bond between the 5' carbon on one strand and the 3' carbon on the other strand.	ligase	Using an arts analogy, explain ligase.
Ligase is a type of enzyme that helps to join two DNA strands together. It does this by creating a covalent bond between the phosphate group on one strand and the sugar group on another, which links the two strands together.	ligase	Using an arts analogy, explain ligase.
Just as an artist needs a canvas, paints, and brushes to create a painting, a process controller needs input variables (such as temperature and pressure), controllers (such as PIDs), and actuators (such as valves) to control a process. The process control block is the diagrammatic representation of this hardware and software configuration.	process control block	Using an arts analogy, explain process control block.
A control block is like the conductor of an orchestra. He or she ensures that each musician plays their part at the right time and in the right way. In a similar way, a control block in computer programming coordinates the actions of different parts of a program so that it runs smoothly and correctly.	process control block	Using an arts analogy, explain process control block.
An analogy for process control block could be an orchestra. The conductor is in charge of the entire performance, ensuring that each musician plays their part at the right time and with the correct intensity. In a similar way, the process control block oversees all aspects of a manufacturing process, making sure everything runs smoothly and on schedule.	process control block	Using an arts analogy, explain process control block.
Encoding a message is much like translating it into another language. The sender takes the original message and encodes it using a specific code or set of symbols. This process makes the message more difficult to decipher for someone who doesn't know the code. The encoded message is then transmitted, usually over a communication channel such as the internet or telephone line. At the other end, the receiver uses an decoding algorithm to translate the coded symbols back into their original form.	message encoding	Using an arts analogy, explain message encoding.
Message encoding is the process of translating a message into a format that can be transmitted. This may involve changing the format of the original message, adding coding information to it, or both. The goal of encoding is to ensure that the message arrives intact and can be decoded properly.	message encoding	Using an arts analogy, explain message encoding.
Message encoding is the practice of transforming the original meaning of a message into something else. This can be done through various methods, including encryption and coding. Message encoding helps to ensure that messages are not easily understood by those who are not authorized to see them, while also protecting their privacy.	message encoding	Using an arts analogy, explain message encoding.
When you go to an art museum, you may see a painting of a woman with a green dress. The painting is made up of thousands of small dots. If you looked at the painting closely, you would see that each dot is different in color and size. The colors and sizes of the dots are what create the image of the woman. Receptor sites are like the individual dots in the painting. Each receptor site is unique in shape and size. When a drug attaches to a receptor site, it creates a new pattern that affects how the brain works.	interaction between drugs and receptor sites	Using an arts analogy, explain interaction between drugs and receptor sites.
When you take a drug, it binds to receptor sites on cells in your body. This interaction causes the drug to change how the cell behaves. The drug may make the cell produce more or less of certain proteins, which can affect things like how you feel or how well you digest food.	interaction between drugs and receptor sites	Using an arts analogy, explain interaction between drugs and receptor sites.
When you take an art class, the first step is to learn about the different tools and mediums that you will be working with. The same is true for drugs and receptor sites - in order to understand how they interact, you need to know what each one is capable of. Drugs are like brushes, while receptor sites are like canvas. Each drug has a unique set of properties, just as each brush has its own unique shape and texture. Some brushes are better suited for painting certain types of pictures than others. The same is true for drugs - some work better on certain types of receptor sites than others.	interaction between drugs and receptor sites	Using an arts analogy, explain interaction between drugs and receptor sites.
A monitor is like the director of an orchestra. They make sure that all of the different instruments are playing together correctly to create a beautiful melody.	monitor	Using an arts analogy, explain monitor.
A monitor is like a piece of artwork that hangs on a wall. It is an object that people can look at and appreciate.	monitor	Using an arts analogy, explain monitor.
A monitor is a device that outputs an image onto a screen. It can be used to display text, images, or videos.	monitor	Using an arts analogy, explain monitor.
In computing, a central processing unit (CPU) is the electronic circuitry within a computer that carries out the instructions of a computer program by performing the basic arithmetical, logical, and input/output operations specified in the instructions.	cpu	Using an arts analogy, explain cpu.
The CPU is the "brain" of the computer. It processes all instructions and data that come into the system. The faster a CPU can process these items, the faster your computer will run.	cpu	Using an arts analogy, explain cpu.
A CPU is a bit like an orchestra conductor. The conductor tells the musicians when to play and how loudly, and ensures that everyone is playing together. In the same way, the CPU controls all of the computer's operations, telling each component what to do and when to do it.	cpu	Using an arts analogy, explain cpu.
The motherboard can be thought of as the canvas for an artist. It is the foundation that everything else is built on. In the same way, the motherboard provides a base for all of the other components in your computer.	motherboard	Using an arts analogy, explain motherboard.
The motherboard is the backbone of a computer. It connects all of the different parts of the computer together and allows them to communicate with each other.	motherboard	Using an arts analogy, explain motherboard.
A motherboard is the frame of a painting. It provides the structure on which everything else is built.	motherboard	Using an arts analogy, explain motherboard.
Ram is the act of pushing data from one computer memory to another.	ram	Using an arts analogy, explain ram.
Ramming is the act of using a blunt object to forcefully collide with an object. In the arts, it can be used as a metaphor to describe when an artist or creator makes a powerful and deliberate impact on their field or community.	ram	Using an arts analogy, explain ram.
Ram is a type of poetry that emphasizes the sound and rhythm of words more than their meaning.	ram	Using an arts analogy, explain ram.
A power supply unit, or PSU, is like the fuel tank for a car. It's what provides power to all of the other components in the system. A good PSU will provide clean and reliable power, while a bad one can cause all sorts of problems.	power supply unit	Using an arts analogy, explain power supply unit.
Just as an artist needs paints, brushes, and canvases to create a painting, a PC requires power supplies, wires, and connectors to function. The power supply unit (PSU) is the component of a PC that converts line voltage into regulated voltages required by the other components. It also provides currents necessary to run those components.	power supply unit	Using an arts analogy, explain power supply unit.
A power supply unit (PSU) is like the engine of a car. It takes AC voltage from the outlet in your house and converts it to DC voltage that your computer can use. The PSU also regulates the amount of power going to your computer, ensuring that it doesn't draw too much or too little current.	power supply unit	Using an arts analogy, explain power supply unit.
The keyboard is like a painter's palette, with each color represented by a key. When the musician presses a key, they are selecting the sound that will be played.	keyboard	Using an arts analogy, explain keyboard.
A keyboard is a musical instrument that is played by pressing keys on the front of the instrument. The keys are arranged in a certain order, and each key corresponds to a note on the scale. When you press down on a key, it strikes a metal bar inside the instrument, which causes a corresponding note to sound.	keyboard	Using an arts analogy, explain keyboard.
A keyboard is like a piano. It has keys that you press to make different sounds.	keyboard	Using an arts analogy, explain keyboard.
Mouse is like a conductor in an orchestra. They don't create the music themselves, but they help to control and guide the musicians to play together harmoniously.	mouse	Using an arts analogy, explain mouse.
Mouse is a tool that artists use to create and manipulate digital art. It allows them to zoom in and out, move around the canvas, and select different tools to apply color, texture, and other effects.	mouse	Using an arts analogy, explain mouse.
Mouse is an input device used to control the movement of a cursor on a computer screen.	mouse	Using an arts analogy, explain mouse.
An audio card is like a painter's palette. Just as a painter can mix different colors on his palette to create new hues, an audio card can combine different sound signals to produce new sounds.	audio card	Using an arts analogy, explain audio card.
An audio card is the equivalent of an artist's canvas and paint. It converts digital signals into sounds that we can hear.	audio card	Using an arts analogy, explain audio card.
An audio card is like a painter's palette. It allows the user to mix and match different sounds to create the perfect audio experience.	audio card	Using an arts analogy, explain audio card.
A video card is like a painter's canvas. The video card holds the image that is to be displayed on the monitor. The video card also determines how many colors are displayed and how clear the image will be.	video card	Using an arts analogy, explain video card.
A video card is like a painter's canvas. It is the surface that the artist uses to create their work.	video card	Using an arts analogy, explain video card.
A video card, also called a graphics card, is a type of computer hardware that outputs images and other visual information for display. It does this by translating digital data into signals that can be understood by a monitor or projector.	video card	Using an arts analogy, explain video card.
When a tree is first planted, it is assigned an age of 0. Every year thereafter, the tree's age is incremented by 1.	tree's age calculation	Using an arts analogy, explain tree's age calculation.
Tree's age calculation is very similar to the way an artist calculates how long it took them to complete a painting. The artist would start by measuring the length and width of the painting, then dividing those two numbers to find the square footage. They would then multiply that number by the number of hours it took them to complete the painting. This gives them an estimate for how long it took them to paint the entire picture. Tree does something very similar; they calculate their age by multiplying their height in meters by their diameter in meters, then divide that number by 1000. This tells us how many cubic meters of wood they've produced in their lifetime. Finally, we can subtract from that total the amount of wood that has been lost due to natural causes like rot or fire, and we have tree's approximate age	tree's age calculation	Using an arts analogy, explain tree's age calculation.
Artists often use the Golden Ratio to calculate the age of a tree. This is done by dividing the height of the tree by the width of its base. The result is usually around 1.6, which means that a tree is approximately one and a sixth times as old as it is wide.	tree's age calculation	Using an arts analogy, explain tree's age calculation.
Glycolysis is the process that breaks down glucose into two molecules of pyruvate.	glycolysis	Using an arts analogy, explain glycolysis.
Glycolysis is the process of breaking down glucose in order to create adenosine triphosphate (ATP) and pyruvate. This process occurs in the cytoplasm of cells and is used as an energy source for many cellular activities.	glycolysis	Using an arts analogy, explain glycolysis.
Glycolysis is the process by which glucose, a simple sugar, is broken down into two molecules of pyruvic acid. The energy released in this process is used to reform adenosine triphosphate (ATP), the body's main source of energy.	glycolysis	Using an arts analogy, explain glycolysis.
When light or any electromagnetic radiation interacts with a molecule, the energy of the radiation can be either absorbed by the molecule or scattered. When it is scattered, some of the energy is transferred to nearby molecules, which then scatter more of the energy in all directions. This process continues until all of the energy has been dissipated. Anti-stokes scattering is a type of scattering that occurs when a molecule scatters more energy in the opposite direction than was originally absorbed. It occurs when the frequency of the radiation matches one of the resonant frequencies of the molecule and results in an exchange of energy between them.	anti-stokes scattering	Using an arts analogy, explain anti-stokes scattering.
Anti-stokes scattering is similar to the way sound waves move away from a source. The energy of the light wave is pushing against the atoms in the material, and when the wave moves away from the atoms, it loses some of its energy. This causes the light waves to scatter in all directions, making the object look cloudy or opaque.	anti-stokes scattering	Using an arts analogy, explain anti-stokes scattering.
When light waves encounter an obstruction, they scatter in all directions. This is known as Raleigh scattering. With anti-stokes scattering, the scattered light waves are directed in the opposite direction of the original wave. This occurs when there is a decrease in intensity of the light wave.	anti-stokes scattering	Using an arts analogy, explain anti-stokes scattering.
Stokes scattering is the scattering of light (or any other type of electromagnetic radiation) by particles that are much smaller than the wavelength of the radiation. The photons impart a small amount of energy to the particles, which then recoil and emit new photons in all directions. This process happens repeatedly as the photons pass through the particle cloud, resulting in a diffusion or spreading out of the light.	stokes scattering	Using an arts analogy, explain stokes scattering.
Stokes scattering is a type of scattering that occurs when light or other electromagnetic radiationinteracts with particles that are much smaller than the wavelength of the radiation. In stokes scattering,forward-scattered radiation is scattered in the same direction as the incident radiation, whileback-scattered radiation is scattered in the opposite direction. This phenomenon can beexplained using the example of a tennis ball being hit by a racquet. When the ball is hit, it scattersradiation (light) in all directions. However, most of the radiation will be scattered in such a waythat it travels away from where the ball was originally hit. Only a small amount of back-scatteredradiation will be directed towards where the ball was originally hit	stokes scattering	Using an arts analogy, explain stokes scattering.
Stokes scattering is the phenomena that occurs when light or other particles interact with a material in such a way as to cause them to change direction. This can be caused by the interaction of light with atoms or molecules in the material, which will cause the light to scatter in all directions.	stokes scattering	Using an arts analogy, explain stokes scattering.
The median lethal dose (LD) is the dosage of a poisonous substance that kills 50% of the test population. It is calculated by administering different dosages to a group of animals and observing which dosage kills half of them. This information can then be used to help determine the toxicity of a substance.	median lethal dose	Using an arts analogy, explain median lethal dose.
A Median Lethal Dose, or LD50, is the dose of a toxin that kills 50% of the test population. It can be used to measure the toxicity of a substance.	median lethal dose	Using an arts analogy, explain median lethal dose.
A median lethal dose, LD50, is the dose of a toxin required to kill half the members of a tested population within a specified time frame. In other words, it's the dosage that will cause death in 50% of those exposed to it.	median lethal dose	Using an arts analogy, explain median lethal dose.
The universe can be thought of as an immense work of art. It is composed of billions upon billions of stars, planets, and other astronomical objects. Each one is unique and beautiful in its own way.	universe	Using an arts analogy, explain universe.
The universe can be thought of as an immense work of art. It is full of color, texture, and variety. Each star is like a unique brushstroke in the sky, and each planet is a different shade of blue or green. The universe is constantly changing, with new stars being born and old ones dying out. It is a never-ending masterpiece that we are lucky enough to witness.	universe	Using an arts analogy, explain universe.
In the most basic sense, the universe can be thought of as an artist's canvas. It is a vast and seemingly infinite space in which everything exists. The universe is home to all matter and energy, as well as the laws that govern them. It has been expanding ever since it came into being billions of years ago and is expected to continue doing so for eons to come.	universe	Using an arts analogy, explain universe.
The enzyme mechanism is like an artist's brush. The artist's brush can create a masterpiece, but it needs the right kind of paint and the correct amount of pressure to do so. In the same way, enzymes need the correct substrate (the paint) and enough energy (pressure) to create something amazing.	enzyme mechanism	Using an arts analogy, explain enzyme mechanism.
Enzyme mechanism is like an artist's brush. The enzyme is the brush and the substrate is the paint. The enzyme binds to the substrate and then starts to catalyze the reaction.	enzyme mechanism	Using an arts analogy, explain enzyme mechanism.
Enzyme mechanism is like an artist's brush. The artist (enzyme) uses the brush to paint a picture on a canvas. The paint (substrate) is carried by the bristles of the brush and deposited where the artist wants it. In much the same way, enzymes use their "brush" (the active site) to guide substrates to specific locations on proteins where they can be converted into new products.	enzyme mechanism	Using an arts analogy, explain enzyme mechanism.
An ANOVA, or analysis of variance, is a statistical test that examines the difference between two or more means. It does this by partitioning the variability in the data into components attributable to different factors (in our example, treatment and error). This helps us understand which factors are responsible for any differences we see in the data.	anova	Using an arts analogy, explain anova.
ANOVA is an acronym for "Analysis of Variance." It's a technique used in statistics to compare the means of two or more groups.	anova	Using an arts analogy, explain anova.
An anova is a statistical analysis that tests the equality of three or more means. It does this by partitioning the total variability in the data into within-group and between-group components.	anova	Using an arts analogy, explain anova.
A thermostat is like a conductor in an orchestra. They make sure the temperature is just right.	thermostat	Using an arts analogy, explain thermostat.
A thermostat is a device that regulates the temperature in a room or building by turning on and off the heating or cooling unit as needed.	thermostat	Using an arts analogy, explain thermostat.
The thermostat is the device in your home that regulates the temperature. It senses whether the room is too hot or too cold and sends a signal to the furnace or air conditioner to turn on or off as needed.	thermostat	Using an arts analogy, explain thermostat.
Chemical equilibrium is like balance in an artwork. If there are too many colors on one side of the painting, it will be unbalanced and look messy. However, if the artist evenly distributes colors throughout the painting, it will appear balanced and harmonious. In the same way, chemical equilibrium occurs when there is a balance between the reactants and products in a reaction.	chemical equilibrium	Using an arts analogy, explain chemical equilibrium.
Chemical equilibrium is like a balance between different artistic elements in a painting. For example, if there is too much blue in the painting, then it will look cold and uninviting. However, if there is too much red, the painting may seem angry or chaotic. In order to create a beautiful work of art, you need to find the perfect balance between these two colors. The same principle applies to chemical equilibrium – if there is too much of one substance present in a reaction, it will disrupt the balance and lead to an unwanted outcome. By adding just the right amount of each substance, you can maintain equilibrium and produce the desired result.	chemical equilibrium	Using an arts analogy, explain chemical equilibrium.
Chemical equilibrium is like the point at which two musicians playing different notes together create a harmonic chord. The molecules in a chemical system reach equilibrium when the rates of the forward and reverse reactions are equal. This allows the concentrations of reactants and products to stay constant over time.	chemical equilibrium	Using an arts analogy, explain chemical equilibrium.
An arts analogy for just-in-time would be a painter who finishes one painting just as he begins another. He does not have any paintings stored in his studio; he creates them as needed. This is very efficient because the painter is only working on two paintings at a time and he does not have to store any unfinished paintings.	just-in-time	Using an arts analogy, explain just-in-time.
Just-in-time is a business model that produces only what is needed, when it is needed. This eliminates waste and helps to keep costs low. It relies on a close relationship with suppliers who can provide the necessary materials just in time.	just-in-time	Using an arts analogy, explain just-in-time.
Just-in-time is a production philosophy that emphasizes the need to produce only what is needed, when it is needed. This approach aims to eliminate waste and ensure that products are not produced until they are ordered by customers.	just-in-time	Using an arts analogy, explain just-in-time.
Adaptive immunity can be thought of as an artist's ability to adapt their creative work in response to the reactions of their audience. In the immune system, adaptive immunity is the process by which B cells and T cells respond to specific pathogens by creating tailored responses that remember how to recognize and fight that pathogen in future infections.	adaptive immunity	Using an arts analogy, explain adaptive immunity.
Adaptive immunity can be thought of as an artist who is able to quickly adapt their work in response to feedback from the audience. In adaptive immunity, the body's white blood cells are constantly monitoring the environment for signs of infection or cancer. If they detect something unusual, they will produce specific antibodies to attack that invader. The advantage of adaptive immunity is that it can respond very quickly to new threats, such as a flu virus that has never been seen before.	adaptive immunity	Using an arts analogy, explain adaptive immunity.
Adaptive immunity is the process by which the immune system "learns" to recognize and respond to specific pathogens. This occurs through the activation of B cells and T cells, which leads to the production of antibodies and lymphocytes that specifically target those pathogens.	adaptive immunity	Using an arts analogy, explain adaptive immunity.
In an electric circuit, the current is analogous to the flow of water in a pipe. The voltage drop across a resistor is analogous to the pressure difference between two points in a pipe. Just as with water, the greater the pressure difference, the greater the flow of current.	ohm's law	Using an arts analogy, explain ohm's law.
Ohm's law is like a musician playing an instrument. If the musician wants to play louder, they need to use more energy (i.e., play harder). If the musician wants to play softer, they need to use less energy. Ohm's law is similar in that it determines how much current will flow through a circuit based on the voltage and resistance of that circuit.	ohm's law	Using an arts analogy, explain ohm's law.
In an electric circuit, the current is analogous to the flow of water in a pipe. The voltage (measured in volts) is equivalent to the water pressure, and the resistance (measured in ohms) is like the diameter of the pipe. Just as with water, increasing the voltage will cause more current to flow through a circuit; and just as with pipes, increasing the resistance will decrease the amount of current that flows.	ohm's law	Using an arts analogy, explain ohm's law.
Transcription is the process of turning a work of art into a set of instructions that can be followed to create a copy of the original artwork.	transcription	Using an arts analogy, explain transcription.
Transcription is like taking a painting and making a copy of it. The painter starts with a blank canvas and creates a work of art. A transcriptionist takes a recording (the painting) and creates another version of it, usually in written form.	transcription	Using an arts analogy, explain transcription.
Transcription is like an artist taking a picture of a person. The artist captures all the details of the person in the photograph. Transcription does the same thing with genetic information.	transcription	Using an arts analogy, explain transcription.
RNA polymerase is a bit like an artist. It takes the instructions from DNA (like a set of blueprints) and creates new RNA molecules (like paintings or sculptures).	rna polymerase	Using an arts analogy, explain rna polymerase.
RNA polymerase is the enzyme responsible for synthesizing RNA from ribonucleotides. It catalyzes the formation of a phosphodiester bond between the 3' end of one ribonucleotide and the 5' end of another, forming a strand of RNA.	rna polymerase	Using an arts analogy, explain rna polymerase.
Rna polymerase is the artist who paints the picture. The rna molecule is the canvas, and the nucleotides are the paint. Rna polymerase uses a set of rules (the genetic code) to put together the nucleotides in a specific order to create a new rna molecule.	rna polymerase	Using an arts analogy, explain rna polymerase.
Ribosomes are like the painters and sculptors of the cell. They take the instructions from DNA and create proteins.	ribosome	Using an arts analogy, explain ribosome.
Ribosomes are the little machines in our cells that build proteins. Just like a machine in a factory, ribosomes have many parts that work together to create something new.	ribosome	Using an arts analogy, explain ribosome.
Ribosomes are like the paint brushes of a painter. They are responsible for taking the instructions from DNA and turning them into proteins.	ribosome	Using an arts analogy, explain ribosome.
The activator protein is like the conductor of an orchestra. It helps to activate other proteins and get them working together to do their job.	activator protein	Using an arts analogy, explain activator protein.
Activator protein is like the conductor of an orchestra. It helps to activate other proteins, which then help to carry out the cell's functions.	activator protein	Using an arts analogy, explain activator protein.
In an arts analogy, activator protein would be the director of a play. The activator protein is responsible for initiating and regulating the transcription of DNA into proteins. Without the activator protein, the genes would not be expressed and no proteins would be produced.	activator protein	Using an arts analogy, explain activator protein.
An electric circuit can be thought of as a system in which electrical energy is converted into other forms of energy, such as light or heat. The system has three basic components: a power source (such as a battery), conductors (wires), and a load (a lightbulb, for example). When the switch is turned on, current flows from the power source through the conductor to the load. This flow of electricity creates an electromagnetic field that lights up the bulb.	electric circuit	Using an arts analogy, explain electric circuit.
An electric circuit is like a set of pipes that carry water. The electrical current is like the water, and the wires are like the pipes.	electric circuit	Using an arts analogy, explain electric circuit.
Electricity is like water in a pipe. The current (flow of electricity) is like the water flow. Voltage is like the water pressure, and resistance is like the size of the pipe.	electric circuit	Using an arts analogy, explain electric circuit.
The hydrophobic effect is the tendency of nonpolar molecules to aggregate in aqueous solutions. This occurs because polar molecules have a strong affinity for water and will orient themselves so that their polar ends are facing the water, while the nonpolar parts of the molecule are oriented away from the water. This leaves large areas of empty space surrounding the polar molecules, which can easily accommodate nonpolar molecules. The result is that nonpolar molecules tend to clump together, an effect known as self-assembly.	hydrophobic effect	Using an arts analogy, explain hydrophobic effect.
The hydrophobic effect is the tendency of nonpolar substances to aggregate in water. In other words, it's the way that oil and water don't mix. The explanation for this phenomenon is electrostatic attraction between the polar water molecules and the nonpolar hydrocarbons.	hydrophobic effect	Using an arts analogy, explain hydrophobic effect.
Water molecules are polar, and thus they are attracted to one another. This attraction is called the hydrogen bond. Nonpolar molecules, such as oil, are not attracted to water because they do not have polarity. The hydrophobic effect occurs when nonpolar molecules are surrounded by water. The water tries to push the nonpolar molecules away from itself, but the strong hydrogen bonds between the water molecules hold them together.	hydrophobic effect	Using an arts analogy, explain hydrophobic effect.
A musician might use a variety of instruments to create a musical masterpiece. Similarly, different proteins in our body work together to create signals that allow our cells to communicate with one another. These proteins are like the instruments in the musician's toolbox, and they play an important role in biological signal transduction.One type of protein that is often involved in signal transduction is called a receptor. Receptors can be found on the surface of cells, and they help relay messages from outside the cell to the inside. When a molecule binds to a receptor, it starts a chain reaction that results in cellular changes. This process is known as signaling, and it allows our cells to respond quickly to changes in their environment.Another type of protein that is essential for signal transduction is called an enzyme. Enzymes catalyze chemical reactions within our cells, and they are also involved in signal transduction pathways. By speeding up these reactions, enzymes help control how signals are transmitted from one cell to another.	biological signal transduction	Using an arts analogy, explain biological signal transduction.
One way to think of signal transduction is as the process that turns a whisper into a shout. In biological terms, this means taking the small signals created by hormones or other molecules and amplifying them so they can be heard throughout the body. This is done through a series of steps, known as a pathway, in which each step amplify the signal before passing it on to the next one. The resulting cascade of biochemical events ultimately triggers some response, such as muscle contraction or release of a hormone.	biological signal transduction	Using an arts analogy, explain biological signal transduction.
Biological signal transduction can be thought of as the process by which an artist transforms a blank canvas into a masterpiece. Just as the artist uses various tools and techniques to create their work of art, cells use proteins and other molecules to convert incoming signals into responses. This process is essential for regulating cellular functions and coordinating activities within the body.	biological signal transduction	Using an arts analogy, explain biological signal transduction.
