Nadh is like a fuel tank in a car. The tank provides energy to the engine, which makes the car go. Nadh is also necessary for the production of ATP, which is like gasoline for the car.	nadh	Explain nadh using an analogy. The analogy should be suitable for a business student.
Nadh can be compared to a salesperson who is successful because they are trustworthy and knowledgeable. The salesperson knows their products well and has built a good relationship with their clients, which allows them to sell more products. In the same way, nadh helps cells produce energy by acting as an enzyme that carries electrons between proteins in the cell. This process allows the cell to function properly and make energy for growth and repair.	nadh	Explain nadh using an analogy. The analogy should be suitable for a business student.
Nadh can be thought of as a "fuel" molecule that is necessary for the production of energy within the body's cells. Just as gasoline is necessary for a car to run, nadh is necessary for cellular respiration (the process by which cells produce energy) to occur.	nadh	Explain nadh using an analogy. The analogy should be suitable for a business student.
Proteins are like the employees of a business. They carry out the essential tasks that keep the company running. Just as businesses need a variety of different employees to complete their work, proteins play many important roles within cells. Some proteins help build new structures, while others break down old ones. Some proteins control chemical reactions, others ferry nutrients around the cell, and still others protect the cell from harm.	proteins	Explain proteins using an analogy. The analogy should be suitable for a business student.
Proteins are like the employees of a business. They do the work that is necessary to keep everything running smoothly.	proteins	Explain proteins using an analogy. The analogy should be suitable for a business student.
A protein can be thought of as a construction worker. The protein is responsible for putting together the building blocks (amino acids) to create something larger and more complex (a functional protein molecule). Just like there are many different types of construction workers with different skills, there are many different types of proteins that have unique functions within the body.	proteins	Explain proteins using an analogy. The analogy should be suitable for a business student.
DNA is like the blueprint of a house. It contains all of the information necessary to construct a particular structure.	dna	Explain dna using an analogy. The analogy should be suitable for a business student.
DNA is like a company's business plan. It is the blueprint for what the company wants to do and how it plans on doing it.	dna	Explain dna using an analogy. The analogy should be suitable for a business student.
DNA is like a recipe for a cake. Just as you need specific ingredients (flour, sugar, eggs, baking powder) in order to make a cake, you need the right building blocks (adenine, thymine, cytosine, guanine) to create DNA.	dna	Explain dna using an analogy. The analogy should be suitable for a business student.
A glycogen molecule can be thought of as a big bucket of glucose molecules. The bucket can be filled up by eating food, and then the glucose molecules in the bucket can be used to provide energy for the body.	glycogen	Explain glycogen using an analogy. The analogy should be suitable for a business student.
Glycogen can be thought of as an employee's energy bank account. Just like a real-life bank, the glycogen account has both a withdrawal limit and a deposit limit. The withdrawal limit is how much energy the employee can use in a day, while the deposit limit is how much energy the employee can store in total.	glycogen	Explain glycogen using an analogy. The analogy should be suitable for a business student.
Glycogen can be thought of as the business equivalent of cash on hand. It is a readily available form of stored energy that can be used to power operations in a hurry. Like cash, glycogen can help businesses cover unexpected costs or take advantage of opportunities when they arise.	glycogen	Explain glycogen using an analogy. The analogy should be suitable for a business student.
Endoplasmic Reticulum is like the mailroom in a business. The mailroom receives and distributes all of the mail for the company. The endoplasmic reticulum receives and distributes all of the proteins for the cell.	endoplasmic reticulum	Explain endoplasmic reticulum using an analogy. The analogy should be suitable for a business student.
Endoplasmic reticulum can be thought of as the office mailroom in a business. The mailroom is where all the letters and packages are sorted and distributed to the correct departments within the company. The endoplasmic reticulum is responsible for sorting and distributing proteins to the correct parts of the cell.	endoplasmic reticulum	Explain endoplasmic reticulum using an analogy. The analogy should be suitable for a business student.
Endoplasmic Reticulum can be compared to the mail room in a business. The mail room receives and distributes all of the incoming and outgoing mail for the company. Similarly, the endoplasmic reticulum receives and distributes all of the proteins for the cell.	endoplasmic reticulum	Explain endoplasmic reticulum using an analogy. The analogy should be suitable for a business student.
The Golgi apparatus can be thought of as the shipping and receiving department for a company. The cells produce products in the cytoplasm of the cell and then package them up in vesicles. These vesicles travel to the golgi, where they are sorted and packaged for delivery to other parts of the cell or to the exterior of the cell.	golgi	Explain golgi using an analogy. The analogy should be suitable for a business student.
The Golgi apparatus can be thought of as the "mailroom" of a business. It receives packages (substrates) from various departments (the ER and ribosomes), processes them, and sends them on to their final destination (the cell membrane).	golgi	Explain golgi using an analogy. The analogy should be suitable for a business student.
The Golgi Apparatus is like the shipping and receiving department of a business. It receives packages (molecules) from different parts of the cell, organizes them, and sends them off to their final destination.	golgi	Explain golgi using an analogy. The analogy should be suitable for a business student.
The plasma membrane can be thought of as a company's front door. It is the first thing that people see when they visit the company, and it is responsible for letting certain things in (such as customers) and keeping other things out (such as pests). The plasma membrane is also responsible for allowing the company to communicate with the outside world.	plasma membrane	Explain plasma membrane using an analogy. The analogy should be suitable for a business student.
The plasma membrane is like the walls of a building. The outside of the building is exposed to the environment, while the inside of the building is protected from the environment. The plasma membrane separates the inside and outside of a cell and protects the cell's contents from the environment.	plasma membrane	Explain plasma membrane using an analogy. The analogy should be suitable for a business student.
The plasma membrane can be likened to a business's storefront. It is the first line of defense against outside contaminants and it allows customers inside while keeping pests out. The plasma membrane also allows goods and services to be exchanged between the business and its customers.	plasma membrane	Explain plasma membrane using an analogy. The analogy should be suitable for a business student.
Lysosomes are like the recycling center of a business. They break down old materials (like cardboard and plastic) into reusable parts that can be used to make new products.	lysosome	Explain lysosome using an analogy. The analogy should be suitable for a business student.
Lysosomes are like the recycling department in a business. They break down old or unusable materials and recycle them into new products.	lysosome	Explain lysosome using an analogy. The analogy should be suitable for a business student.
A lysosome is like a recycling center for a business. The lysosomes recycles old or damaged products and turn them into new products to be used again.	lysosome	Explain lysosome using an analogy. The analogy should be suitable for a business student.
Peroxisomes can be thought of as the "factories" of the cell. Just like a real factory, peroxisomes produce important products that are used by the rest of the cell. The products that peroxisomes produce include hydrogen peroxide and fatty acids.	peroxisomes	Explain peroxisomes using an analogy. The analogy should be suitable for a business student.
Peroxisomes can be thought of as the "factories" of a cell. Just as a factory is responsible for producing goods, peroxisomes are responsible for producing cellular enzymes and other proteins.	peroxisomes	Explain peroxisomes using an analogy. The analogy should be suitable for a business student.
Peroxisomes are like the quality control department of a business. They inspect products and make sure they meet the company's standards before sending them out to customers. If something is not up to par, peroxisomes will eliminate it from the product line.	peroxisomes	Explain peroxisomes using an analogy. The analogy should be suitable for a business student.
Mitochondria can be thought of as the engines or powerhouses of the cell. Just as a car needs gasoline to run, cells need energy in order to function. This energy is provided by mitochondria, which convert food molecules into ATP (adenosine triphosphate), the body's primary source of energy.	mitochondria	Explain mitochondria using an analogy. The analogy should be suitable for a business student.
Mitochondria can be likened to the engines of a car. They take in fuel (carbohydrates and oxygen) and convert it into energy that the cell can use. Mitochondria are also responsible for apoptosis, or programmed cell death, which helps rid the body of damaged or old cells.	mitochondria	Explain mitochondria using an analogy. The analogy should be suitable for a business student.
Mitochondria can be thought of as the batteries in a business. They are responsible for providing energy to the cells, which allows the business to run smoothly.	mitochondria	Explain mitochondria using an analogy. The analogy should be suitable for a business student.
A chloroplast can be thought of as a solar panel for a business. The plant uses the energy from the sun to create glucose from carbon dioxide and water. This glucose can then be used by the business to run operations, just like regular electricity from the power grid.	chloroplast	Explain chloroplast using an analogy. The analogy should be suitable for a business student.
Chloroplasts are to plants what lungs are to humans. Chloroplasts help convert sunlight into energy that the plant can use, just as lungs help convert oxygen into energy that a human can use.	chloroplast	Explain chloroplast using an analogy. The analogy should be suitable for a business student.
A chloroplast is a bit like the engine in a car. It takes energy from the sun and converts it into glucose, which the plant can use to grow and thrive.	chloroplast	Explain chloroplast using an analogy. The analogy should be suitable for a business student.
The cytoskeleton can be thought of as the scaffolding inside a building. The scaffolding provides support to the workers and materials while the construction is taking place. In the same way, the cytoskeleton supports and organizes the cell's contents while it is functioning.	cytoskeleton	Explain cytoskeleton using an analogy. The analogy should be suitable for a business student.
The cytoskeleton can be thought of as the skeletal system of a business. Just like our bones support our body and allow us to move, the cytoskeleton supports the cell and allows it to move. Additionally, just as muscles attach to our skeleton and help us move, proteins called motor proteins attach to the cytoskeleton and help the cell move around.	cytoskeleton	Explain cytoskeleton using an analogy. The analogy should be suitable for a business student.
The cytoskeleton analogy would be something like the scaffolding on a construction site. The scaffolding is used to support the workers and materials while the construction project is underway. In a similar way, the cytoskeleton supports and organizes the cell's contents while it is functioning.	cytoskeleton	Explain cytoskeleton using an analogy. The analogy should be suitable for a business student.
ATP is like the oil in a car. It's what makes the engine run.	atp	Explain atp using an analogy. The analogy should be suitable for a business student.
ATP can be thought of as the "currency" of the cell - it is used to pay for all cellular activities. Just like a business needs money to pay for employees, supplies, and rent, cells need ATP to pay for proteins, enzymes, and other cellular components.	atp	Explain atp using an analogy. The analogy should be suitable for a business student.
Atp is to a business as gasoline is to a car. Just as gasoline powers a car and allows it to move, atp powers the cells in our body and allows us to move.	atp	Explain atp using an analogy. The analogy should be suitable for a business student.
NADPH can be thought of as the "fuel" that powers the electron transport chain in photosynthesis. Just as gasoline powers a car, NADPH powers the reactions that occur in photosynthesis. It is essentially like a battery for plants - it provides them with energy to convert sunlight into useful forms of chemical energy like glucose.	nadph	Explain nadph using an analogy. The analogy should be suitable for a business student.
Nadph can be thought of as the "fuel" that helps a business run. It is necessary for many of the chemical reactions that occur in cells, including those that produce energy. Just like gasoline powers a car, nadph helps power cellular activities.	nadph	Explain nadph using an analogy. The analogy should be suitable for a business student.
NADPH is like the "fuel" that helps keep a business running. It's used to create new products, run machines, and do all sorts of other things that are necessary for the company to function.	nadph	Explain nadph using an analogy. The analogy should be suitable for a business student.
Peroxysomes are like the recycling department of a business. They take used materials and break them down into reusable parts. This allows the company to reuse valuable resources instead of having to create new ones from scratch.	peroxysome	Explain peroxysome using an analogy. The analogy should be suitable for a business student.
A peroxysome is like a super-sized kitchen garbage can. It's big enough to hold all the waste from the entire kitchen - including food scraps, dirty dishes and pots and pans. The peroxysome breaks down the waste into smaller pieces that can be easily flushed away or recycled.	peroxysome	Explain peroxysome using an analogy. The analogy should be suitable for a business student.
A peroxysome is like a tiny factory inside of each cell. It makes molecules called "peroxides" which help to break down food and other materials in the cell.	peroxysome	Explain peroxysome using an analogy. The analogy should be suitable for a business student.
The mitochondria can be compared to the engine of a car. Just as the engine provides power to the car, the mitochondria provide energy to the cell.	mytochondria	Explain mytochondria using an analogy. The analogy should be suitable for a business student.
The mitochondria can be thought of as the engines of the cell. Just like an engine needs fuel to run, the mitochondria need energy to function. The cells get this energy from food, which is broken down in the mitochondria.	mytochondria	Explain mytochondria using an analogy. The analogy should be suitable for a business student.
The mitochondria can be thought of as the "powerhouse" of the cell. Just as a business needs an efficient and reliable power source to run smoothly, the cells need mitochondria to produce energy for various cellular functions.	mytochondria	Explain mytochondria using an analogy. The analogy should be suitable for a business student.
One way to think about electric forces is to imagine them as a kind of "stickiness" between electrically charged particles. Like two pieces of sticky tape, the more charge there is on each particle, the more force there will be between them. This analogy can help you understand why objects with different charges attract or repel each other.	electric forces	Explain electric forces using an analogy. The analogy should be suitable for a business student.
Electric forces are like the attraction between magnets. Just as two magnets will be drawn together, electric charges will be attracted to one another.	electric forces	Explain electric forces using an analogy. The analogy should be suitable for a business student.
Electricity is like money. Money flows through the economy, and it can be used to buy things. Electricity flows through circuits, and it can be used to power things.	electric forces	Explain electric forces using an analogy. The analogy should be suitable for a business student.
A hydrogen electron's orbital can be thought of as an employee who is assigned to a specific department within a company. This employee is responsible for carrying out tasks and duties that are associated with their department.	hydrogen electron's orbital	Explain hydrogen electron's orbital using an analogy. The analogy should be suitable for a business student.
The orbital of a hydrogen electron can be thought of as a seat on an airplane. The higher the number of the seat, the more "up in the air" it is. Similarly, the higher the energy level of an orbital, the more removed its electron is from the nucleus.	hydrogen electron's orbital	Explain hydrogen electron's orbital using an analogy. The analogy should be suitable for a business student.
Think of an orbital as a company's office. The electron is the worker who occupies the office. There are many different types of orbitals, just like there are many different types of offices in a company. Some offices have more windows than others, some have more space, and some have better views. But each office has its own unique characteristics that make it perfect for a specific worker.	hydrogen electron's orbital	Explain hydrogen electron's orbital using an analogy. The analogy should be suitable for a business student.
The analogy should be of a business student.One line of defense in the body could be thought of as an employee who is always working and is never absent. This person is always there to keep things running smoothly and handle any emergencies that may come up.	first line of defense in the body	Explain first line of defense in the body using an analogy. The analogy should be suitable for a business student.
The analogy for the first line of defense in the body would be like having a security guard at the front door of a business. They are the first people that anyone coming into contact with is going to see and they are responsible for deciding if someone should be allowed inside or not. In the same way, your immune system is responsible for detecting and stopping any intruders (like bacteria or viruses) from entering your body.	first line of defense in the body	Explain first line of defense in the body using an analogy. The analogy should be suitable for a business student.
One analogy for the body's first line of defense is a corporation's human resources department. The HR department screens potential employees, reviews their qualifications, and conducts background checks to ensure that they are a good fit for the company and that they have no red flags in their past. Similarly, the body's first line of defense is responsible for screening out potential threats, such as bacteria or viruses, and preventing them from entering the body.	first line of defense in the body	Explain first line of defense in the body using an analogy. The analogy should be suitable for a business student.
A macrophage can be thought of as the "janitor" of the immune system. Like a janitor, they patrol the body cleaning up any debris or pathogens that they encounter. They are also responsible for presenting foreign antigens to other cells of the immune system so that they can mount an appropriate response.	macrophages	Explain macrophages using an analogy. The analogy should be suitable for a business student.
Macrophages are the "janitors" of the immune system. They clean up debris and damaged cells. analogy: Macrophages are like the janitors of a business. They clean up debris and damaged cells.	macrophages	Explain macrophages using an analogy. The analogy should be suitable for a business student.
One analogy for macrophages could be corporate executives. Just as the body's macrophages engulf and destroy foreign invaders, business executives identify and eliminate threats to their company. Additionally, both macrophages and executives play a key role in maintaining the health of their organizations.	macrophages	Explain macrophages using an analogy. The analogy should be suitable for a business student.
A t-helper cell is a bit like a project manager. It helps to organize and coordinate the activities of other cells (such as B cells and T cells) in order to mount an effective immune response.	t-helper cells	Explain t-helper cells using an analogy. The analogy should be suitable for a business student.
A t-helper cell is like an air traffic controller at an airport. The controller tells the pilots which runways to use and how to get to their destinations. In the same way, the t-helper cell tells the other cells in the immune system what to do and where to go.	t-helper cells	Explain t-helper cells using an analogy. The analogy should be suitable for a business student.
T-helper cells can be thought of as the "customer service" department for the immune system. They help to activate other immune cells and direct them toward invaders or infection sites. Just like a good customer service department helps to solve problems and resolve complaints, t-helper cells help to mobilize the rest of the immune system to fight off infections.	t-helper cells	Explain t-helper cells using an analogy. The analogy should be suitable for a business student.
B-lymphocytes are similar to employees in a business. They originate from bone marrow, and they mature there before moving into the lymph nodes. There, they patrol the body for invaders like viruses or bacteria. When they find something that doesn't belong, they produce antibodies to fight it off.	b-lymphocytes	Explain b-lymphocytes using an analogy. The analogy should be suitable for a business student.
B-lymphocytes are like the HR department of a company. They are responsible for recruiting new employees (T-cells) and training them to do their jobs.	b-lymphocytes	Explain b-lymphocytes using an analogy. The analogy should be suitable for a business student.
B-lymphocytes are like employees in a business. They work to protect the company by attacking any viruses or bacteria that enter it.	b-lymphocytes	Explain b-lymphocytes using an analogy. The analogy should be suitable for a business student.
Cytotoxic T-lymphocytes can be compared to a company's security team. The security team's job is to protect the company from harm, and the cytotoxic T-lymphocytes' job is to protect the body from harm. Like a good security team, the cytotoxic T-lymphocytes are always on alert and ready to respond quickly if they need to.	cytotoxic t-lymphocytes	Explain cytotoxic t-lymphocytes using an analogy. The analogy should be suitable for a business student.
A cytotoxic t-lymphocyte can be thought of as a "sniper" of the immune system. Just like a sniper takes out specific targets from a distance, cytotoxic t-lymphocytes identify and destroy cancer cells or cells that are infected with viruses. They do this by recognizing proteins on the surface of these cells that are not found on healthy cells.	cytotoxic t-lymphocytes	Explain cytotoxic t-lymphocytes using an analogy. The analogy should be suitable for a business student.
A cytotoxic t-lymphocyte is like a soldier in the immune system. The soldier's job is to protect the body from invaders, such as bacteria and viruses. The soldier carries a weapon (cytokines) that can kill the invaders.	cytotoxic t-lymphocytes	Explain cytotoxic t-lymphocytes using an analogy. The analogy should be suitable for a business student.
If bacteria were people, they would be like the United States military. They are always looking for new territory to conquer and expand their empire. Once they invade a new area, they start reproducing rapidly, taking over everything in their path.	invasion of bacterias	Explain invasion of bacterias using an analogy. The analogy should be suitable for a business student.
Bacteria invading a business can be thought of as an infection. Just as an infection in the body can spread and cause all sorts of problems, bacteria invading a business can spread quickly and cause all sorts of trouble. Infected businesses may have to close their doors until the problem is sorted out, just like infected bodies need time to heal.	invasion of bacterias	Explain invasion of bacterias using an analogy. The analogy should be suitable for a business student.
One way to think about bacterial invasion is to imagine it as a hostile takeover of a business. The bacteria are like the invading company, and they try to take over the host cells—the employees of the business—in order to use them for their own purposes. The host cells may resist at first, but eventually the bacteria can often get the upper hand and take over completely. This process can damage or even kill the host cells, leading to infection or disease.	invasion of bacterias	Explain invasion of bacterias using an analogy. The analogy should be suitable for a business student.
A business analogy for the action potential would be a company that has just received an influx of new orders. The company's workers are suddenly very busy and they are working as fast as they can to get all of the new orders completed. This is analogous to how the sodium channels in a neuron open up when it receives a signal and allow sodium ions to flow into the cell. This causes the neuron to become excited and fire off a message down its axon.	action potential	Explain action potential using an analogy. The analogy should be suitable for a business student.
Action potential can be thought of as a surge of electricity through a business. This electricity is what powers the business and allows it to function. The action potential is created by the movement of ions across the cell membrane.	action potential	Explain action potential using an analogy. The analogy should be suitable for a business student.
Action potential can be described as a flow of electricity that travels through the body. This analogy might be suitable for a business student who is familiar with how electricity flows through circuits in order to power machines or light bulbs. Just as electricity needs a pathway (a circuit) to flow, so does the electrical signal that creates the action potential. The cells that create this signal are like batteries, and they need to be connected (by special proteins called ion channels) in order for the current to flow. When something happens to excite these cells (like touching them), it's kind of like flipping on a switch: the current starts flowing and quickly spreads throughout the entire nerve cell.	action potential	Explain action potential using an analogy. The analogy should be suitable for a business student.
Chromatography is like trying to figure out the recipe for a secret sauce. You have a list of ingredients, but you don't know how much of each ingredient to use. You try different amounts of each ingredient and see which combination makes the best sauce.	experiment of chromatography	Explain experiment of chromatography using an analogy. The analogy should be suitable for a business student.
A business analogy for chromatography would be to think of the different colors of ink used in a printer as being like the molecules in a liquid sample. The black ink is like the most concentrated molecule solution and the other colors are less concentrated, with each color having its own unique concentration. When you print something, the black ink is sent through the printer head first and the other colors are layered on top of it. This is basically what happens when you run a chromatographic separation: The most concentrated molecules (the "black ink") travel fastest through the column and the less concentrated molecules take longer to pass through. By looking at how long it takes each color to travel through the column, you can get an idea about how concentrated they are relative to one another.	experiment of chromatography	Explain experiment of chromatography using an analogy. The analogy should be suitable for a business student.
Chromatography is a technique used to separate the individual components of a mixture. The analogy would be like having several employees working on different parts of a project. Each employee has their own task and by the end of the day, the project is complete.	experiment of chromatography	Explain experiment of chromatography using an analogy. The analogy should be suitable for a business student.
Stars like our Sun have a lifespan of about 10 billion years. An analogy for this is that a star is like a typical business. A typical business has an expected lifetime of around 10 years. Just as with businesses, stars can last longer or shorter than their average lifetime, depending on the circumstances.	main-sequence lifetimes of stars	Explain main-sequence lifetimes of stars using an analogy. The analogy should be suitable for a business student.
Stars spend the majority of their lives as main-sequence stars. During this time, they fuse hydrogen into helium in their cores, and this process releases energy that makes the star shine. The amount of time a star spends on the main sequence depends on its mass; more massive stars burn through their fuel faster and move off the main sequence sooner than less massive stars.	main-sequence lifetimes of stars	Explain main-sequence lifetimes of stars using an analogy. The analogy should be suitable for a business student.
A star's life can be thought of as a business. The main sequence lifetime is the time that the company is in its prime, growing and making money. After this, it may experience a decline (like a business going downhill), or it may keep going strong for many more years.	main-sequence lifetimes of stars	Explain main-sequence lifetimes of stars using an analogy. The analogy should be suitable for a business student.
Nucleus is the CEO or president of a company. He/she is in charge of making decisions for the company and its employees. The nucleus makes sure everything runs smoothly and that everyone has what they need to do their jobs.	nucleus	Explain nucleus using an analogy. The analogy should be suitable for a business student.
The nucleus of a business is the CEO. The CEO is in charge of making decisions that affect the entire company. They are like the brain of the business and make sure everything runs smoothly.	nucleus	Explain nucleus using an analogy. The analogy should be suitable for a business student.
The nucleus is the CEO of a company. It makes all the important decisions and oversees everything that goes on in the company.	nucleus	Explain nucleus using an analogy. The analogy should be suitable for a business student.
Ribosomes are like the machines in a factory. The instructions for making the product come from the DNA (the blueprints), and the ribosomes read these instructions and build the product.	ribosomes	Explain ribosomes using an analogy. The analogy should be suitable for a business student.
Ribosomes are the workers in a factory. They make the products that the factory produces.	ribosomes	Explain ribosomes using an analogy. The analogy should be suitable for a business student.
Ribosomes can be thought of as the assembly line workers in a factory. The DNA is like the blueprints for the product that needs to be made, and the ribosomes are responsible for reading those blueprints and assembling the product.	ribosomes	Explain ribosomes using an analogy. The analogy should be suitable for a business student.
The Golgi apparatus is like the shipping and receiving department of a business. The cells produce products in the cytoplasm (the warehouse), which are then packaged up and sent to the Golgi apparatus (the shipping department). The Golgi apparatus processes and packages the products, and then sends them on to their final destination (the customer).	golgi apparatus	Explain golgi apparatus using an analogy. The analogy should be suitable for a business student.
The Golgi apparatus can be thought of as a mailroom in a business. The mailroom receives letters (packages) from all over the building (the body), sorts them by department, and delivers them to the appropriate person's mailbox.	golgi apparatus	Explain golgi apparatus using an analogy. The analogy should be suitable for a business student.
The golgi apparatus is like a shipping and receiving department in a business. It receives packages (molecules) from various parts of the cell, sorts them, and sends them to their appropriate destinations.	golgi apparatus	Explain golgi apparatus using an analogy. The analogy should be suitable for a business student.
Lysosomes are like the recycling center for a business. They break down old products and materials so that they can be reused or recycled. This helps to keep the business running efficiently and reduces waste.	lysosomes	Explain lysosomes using an analogy. The analogy should be suitable for a business student.
Lysosomes can be thought of as the "garbage disposal units" of a cell. Just like in your home, when something is thrown away that doesn't belong, it goes into the garbage disposal to be broken down and disposed of. Lysosomes do the same thing within cells - they break down any waste or old materials so that the cell can use those resources again.	lysosomes	Explain lysosomes using an analogy. The analogy should be suitable for a business student.
Lysosomes are like a company's recycling department. They recycle materials that would otherwise be waste and turn them into something useful again. Lysosomes break down old proteins, lipids, and nucleic acids into their component parts so that the cell can reuse them.	lysosomes	Explain lysosomes using an analogy. The analogy should be suitable for a business student.
Nuclear envelope can be thought of as the company’s human resources department. The nuclear envelope is responsible for managing the internal and external communication of the nucleus, as well as organizing and controlling the movement of proteins and other molecules into and out of the nucleus.	nuclear envelope	Explain nuclear envelope using an analogy. The analogy should be suitable for a business student.
The nuclear envelope can be thought of as a company's board of directors. The board of directors is responsible for making decisions that affect the company, while the nuclear envelope is responsible for controlling the cell's DNA and producing proteins.	nuclear envelope	Explain nuclear envelope using an analogy. The analogy should be suitable for a business student.
Nuclear envelope can be analogized as a human resources department in a business. The nuclear envelope manages and oversees the distribution of genetic information (DNA) within the cell, similar to how a human resources department oversees the distribution of employee salaries and benefits within a company. Additionally, just as businesses must comply with government regulations related to employee compensation, cells are regulated by laws that dictate how DNA is packaged and distributed within them.	nuclear envelope	Explain nuclear envelope using an analogy. The analogy should be suitable for a business student.
A vacuole can be thought of as a storage closet in a business. The vacuoles can store extra resources, such as food or water, that the cell may need later.	vacuoles	Explain vacuoles using an analogy. The analogy should be suitable for a business student.
A vacuole can be thought of as a storage container in the business world. Just like you might store extra office supplies or inventory in a closet or warehouse, the cell stores excess molecules or water in its vacuole.	vacuoles	Explain vacuoles using an analogy. The analogy should be suitable for a business student.
A vacuole is like a storage room in a business. It can be used to store supplies or products that are not currently being used.	vacuoles	Explain vacuoles using an analogy. The analogy should be suitable for a business student.
The cytoplasm can be thought of as the "human resources" department of a company. Just as this department is responsible for recruiting and training new employees, the cytoplasm is responsible for organizing and managing the cellular components that make up a cell.	cytoplasm	Explain cytoplasm using an analogy. The analogy should be suitable for a business student.
Cytoplasm is like the water that fills a fish tank. It surrounds and supports the fish, provides them with oxygen and nutrients, and allows them to move around. In the same way, cytoplasm surrounds and supports the cells' organelles, provides them with nutrients and oxygen, and lets them move around.	cytoplasm	Explain cytoplasm using an analogy. The analogy should be suitable for a business student.
Cytoplasm can be thought of as the "blood" or "life force" of a cell. It is a thick, viscous fluid that surrounds and supports the cell's organelles. Just as blood carries oxygen and nutrients to the body's cells, cytoplasm provides essential nutrients and support to the cell's organelles.	cytoplasm	Explain cytoplasm using an analogy. The analogy should be suitable for a business student.
Chromosomes are like the blueprints for a company. They contain all of the information that is needed to create the company, including the names of the owners, their contact information, and the type of business that they operate.	chromosome	Explain chromosome using an analogy. The analogy should be suitable for a business student.
Chromosomes are like strands of DNA in a business. They hold all the important information that makes the company run, and they need to be protected at all costs. If something happens to them, the business might not be able to survive.	chromosome	Explain chromosome using an analogy. The analogy should be suitable for a business student.
Chromosomes are like folders in a filing cabinet. Each chromosome holds all of the genetic information for a certain trait or characteristic.	chromosome	Explain chromosome using an analogy. The analogy should be suitable for a business student.
The cytosol can be analogy to the water in a fish tank. The water is essential for the survival of the fish, and it surrounds and supports them. In much the same way, the cytosol provides an environment for cells to live and function in.	cytosol	Explain cytosol using an analogy. The analogy should be suitable for a business student.
The cytosol can be thought of as the water in a fish tank. It is the fluid that surrounds all of the cells in the tank and provides them with nutrients and oxygen. In a similar way, the cytosol surrounds all of the cells in your body and provides them with nutrients and oxygen.	cytosol	Explain cytosol using an analogy. The analogy should be suitable for a business student.
A cytoskeleton is like the scaffolding in a construction site. It supports and holds everything together while work is being done. The cytosol is like the cement that fills in the gaps between the scaffolding tubes.	cytosol	Explain cytosol using an analogy. The analogy should be suitable for a business student.
A cell is like a small business. The cell has a lot of different parts that all work together to make the business run. The nucleus is like the CEO, who makes decisions for the company. The cytoplasm is like the workers, who do the actual work of the company. And the plasma membrane is like the door, keeping things in and out of the company.	cell	Explain cell using an analogy. The analogy should be suitable for a business student.
A cell is like a small business. It has employees (the organelles), a boss (the nucleus), and it produces something that people need to survive (protein, oxygen).	cell	Explain cell using an analogy. The analogy should be suitable for a business student.
A cell is like a small business. It has a limited amount of resources and it must use them wisely in order to survive and grow.	cell	Explain cell using an analogy. The analogy should be suitable for a business student.
Think of vesicles as the 'envelopes' that are used to send mail. Just like an envelope can protect a letter from getting wet or damaged, vesicles can protect the cells contents from damage.	vesicles	Explain vesicles using an analogy. The analogy should be suitable for a business student.
Vesicles are like small, private companies. They are smaller and more specialized than the big public companies. They have a limited number of employees and a focused product or service. Vesicles may be bought or sold, but they are not as easily traded as stock in a public company.	vesicles	Explain vesicles using an analogy. The analogy should be suitable for a business student.
A vesicle is like a small container that can hold a limited amount of something. It's like a tiny box that you can use to store things in.	vesicles	Explain vesicles using an analogy. The analogy should be suitable for a business student.
A cell wall is like a company's firewall. It protects the company's internal data from being accessed by unauthorized users outside of the company.	cell wall	Explain cell wall using an analogy. The analogy should be suitable for a business student.
A cell wall can be thought of as a company's firewall. It is a barrier that keeps unauthorized people from accessing the company's data and resources. Like a firewall, a cell wall also protects the company from outside attacks.	cell wall	Explain cell wall using an analogy. The analogy should be suitable for a business student.
A cell wall is like a company's firewall. It helps to protect the company from unauthorized access and also protects the data inside the company.	cell wall	Explain cell wall using an analogy. The analogy should be suitable for a business student.
Cells are like businesses. Just as businesses need workers to function, cells need proteins to carry out their functions. The cell membrane is like the storefront of a business where customers can interact with the products inside. The nucleus is like the manager of a business who makes decisions about how the company should run.	cells	Explain cells using an analogy. The analogy should be suitable for a business student.
Cells are like small businesses. Just as a business has a CEO, cells have a nucleus. Cells also have workers (mitochondria) and managers (ribosomes).	cells	Explain cells using an analogy. The analogy should be suitable for a business student.
Cells are the basic building blocks of life just as businesses are the basic building blocks of economies. Just as each cell has a specific task to carry out in order for an organism to survive, each business has a specific task to carry out in order for an economy to function. Cells can divide and multiply to create new cells, just as businesses can expand and contract to create new businesses. Cells communicate with one another via chemical signals, just as businesses communicate with one another via financial signals. And finally, both cells and businesses need energy in order to thrive - in the form of glucose for cells and profits for businesses.	cells	Explain cells using an analogy. The analogy should be suitable for a business student.
A cell membrane is like a bouncer at a nightclub. It allows some people (substances) to get in while keeping others out.	cell membrane	Explain cell membrane using an analogy. The analogy should be suitable for a business student.
A cell membrane is like a company’s receptionist. The receptionist is responsible for screening everyone who wants to enter the company and decides which people are allowed in. Similarly, the cell membrane screens everything that enters or leaves the cell and decides what substances are allowed to cross it.	cell membrane	Explain cell membrane using an analogy. The analogy should be suitable for a business student.
A cell membrane can be thought of as a fence or wall around the cell. It is made up of a lipid bilayer (two layers of fat) with proteins embedded in it. The purpose of the cell membrane is to protect the cells and keep things out (e.g., waste products, bacteria). It also allows things to enter and leave the cell, such as nutrients and oxygen.	cell membrane	Explain cell membrane using an analogy. The analogy should be suitable for a business student.
Think of the golgi body as a factory. The factory takes in raw materials (carbon, hydrogen, nitrogen, oxygen) and produces products (proteins, enzymes, lipids). The products are then packaged and sent to other parts of the cell or out of the cell altogether.	golgi body	Explain golgi body using an analogy. The analogy should be suitable for a business student.
The Golgi body can be thought of as a shipping and receiving department for the cell. It receives proteins from the endoplasmic reticulum, modifies them, and then sends them off to their final destinations. The analogy would be a business that receives products from suppliers, modifies them, and then ships them to retailers.	golgi body	Explain golgi body using an analogy. The analogy should be suitable for a business student.
The Golgi body can be thought of as the shipping and receiving department for a business. It takes packages (molecules) from various departments (cellular organelles), sorts them, and sends them off to their final destinations.	golgi body	Explain golgi body using an analogy. The analogy should be suitable for a business student.
One way to think about capacitance is to imagine it as a bank account. Capacitance is like the total amount of money in your account, while voltage is akin to how much you can withdraw from your account at any one time. Current would be the rate at which you are withdrawing money (or electricity in this analogy). Just as with a bank account, if you have more capacitance, you can withdraw more current without having to increase the voltage.	capacitance	Explain capacitance using an analogy. The analogy should be suitable for a business student.
Think of capacitance as a like a container filled with water. The more water that is in the container, the higher the capacitance will be. Just like capacitance, the more people that are in your business, the more potential customers you have.	capacitance	Explain capacitance using an analogy. The analogy should be suitable for a business student.
Think of capacitance as a bank account. Just like you can deposit or withdraw money from your bank account, electric current can be either deposited (charging the capacitor) or withdrawn (discharging the capacitor) from a capacitor. The size of your bank account is determined by how much money you have deposited (the capacitance), and how quickly you can make withdrawals (the discharge rate).	capacitance	Explain capacitance using an analogy. The analogy should be suitable for a business student.
Electric current is like the flow of money in a company. Just as money needs to be flowing in order for the company to function, electric current is needed to power devices. The analogy can be extended further by thinking about how businesses need to manage their finances and track where money is coming from and going to. In the same way, homes and businesses need to manage their electricity consumption by using gadgets like smart meters that measure how much electricity different appliances are using.	electric current	Explain electric current using an analogy. The analogy should be suitable for a business student.
Electric current is like the flow of water in a hose. Just as the amount of water flowing through a hose depends on how wide the opening at the end is, the amount of electric current passing through a wire depends on how much voltage (pressure) is applied to it.	electric current	Explain electric current using an analogy. The analogy should be suitable for a business student.
Electric current is like the flow of money in a business. Just as money needs to be constantly flowing in order for a business to thrive, electric current needs to be constantly moving in order for devices to function. If there's no money coming in (no current), the business will eventually fail. The same goes for if there's no electricity (no current), devices won't work.	electric current	Explain electric current using an analogy. The analogy should be suitable for a business student.
Voltage is like the water pressure in a city. Just as the higher water pressure can push further through pipes, a higher voltage can push more electricity through wires. Voltage is also like traffic on a highway. The higher the voltage, the more cars can flow through the road at once.	voltage	Explain voltage using an analogy. The analogy should be suitable for a business student.
Think of voltage as the pressure of a fluid. Just as water can flow through a pipe under different levels of pressure, electrical current can flow through a wire under different levels of voltage.	voltage	Explain voltage using an analogy. The analogy should be suitable for a business student.
Voltage is like water pressure. Just as the higher water pressure in a hose can push more water through it, a higher voltage can push more electricity through a wire.	voltage	Explain voltage using an analogy. The analogy should be suitable for a business student.
One way to think about the specialization and communication within cells is to imagine a large company with many different divisions. Each division has a specific task - marketing, accounting, product development, etc. - that it specializes in. The divisions communicate with each other in order to complete tasks such as developing a new product or advertising it. In the same way, cells specialize in different tasks - such as cell growth, DNA replication, and protein production - and they communicate with each other to carry out these functions.	specialization and communication in a cell	Explain specialization and communication in a cell using an analogy. The analogy should be suitable for a business student.
A business analogy for specialization and communication in a cell would be the division of labor within a company. In any company, there are employees who specialize in specific tasks and those employees communicate with one another to carry out the various tasks required to run the company. The same is true for cells. Cells specialize in different tasks and they communicate with each other to carry out the functions necessary for life.	specialization and communication in a cell	Explain specialization and communication in a cell using an analogy. The analogy should be suitable for a business student.
Cell specialization can be likened to a business with different areas of expertise. The marketing department is responsible for promoting the company and its products, while the accounting department keeps track of the finances. Each area has a specific function, but they all work together to achieve the overall goal of the business. In much the same way, cells specialize in different tasks but must communicate with one another to ensure that the organ functions as a whole.	specialization and communication in a cell	Explain specialization and communication in a cell using an analogy. The analogy should be suitable for a business student.
Just as in a business when money is transferred from one account to another, the total amount of money in the system stays the same, so too in an electrical circuit the total voltage across all points in the system remains constant.	kirchoff's voltage law	Explain kirchoff's voltage law using an analogy. The analogy should be suitable for a business student.
Kirchoff's voltage law states that the sum of all voltages in a closed circuit is equal to zero. This can be thought of as an equation balancing out the amount of money coming into and leaving a business. The total amount of incoming cash (income) must be equal to the total outgoing cash (expenses).	kirchoff's voltage law	Explain kirchoff's voltage law using an analogy. The analogy should be suitable for a business student.
Kirchoff's voltage law states that the sum of all voltages in a circuit is equal to zero. This can be thought of as electrical current flowing like water through a pipe. If you have two hoses connected to a faucet, with one hose higher than the other, the water will flow from the high hose to the low hose until they are both at the same height. In the same way, electricity will flow from any point in a circuit with a higher voltage to any point with a lower voltage until they are all at the same level.	kirchoff's voltage law	Explain kirchoff's voltage law using an analogy. The analogy should be suitable for a business student.
A density wave can be thought of as a "wave" of people moving through a room. The people at the front of the wave are packed tightly together, while the people at the back are much more spread out. In business terms, this would be analogous to a company having high sales volume but low profits, or vice versa.	nature of a density wave	Explain nature of a density wave using an analogy. The analogy should be suitable for a business student.
A density wave can be thought of as a "wave" of people or objects moving through a medium. For example, imagine you are in a room with 100 people. If someone stands up and starts walking around the room, they will cause other people to stand up and follow them. This "wave" of standing people will move through the room until everyone has stood up.	nature of a density wave	Explain nature of a density wave using an analogy. The analogy should be suitable for a business student.
A density wave is like a group of people standing in line at a fast food restaurant. The people are all close together at the beginning of the line, but as they move forward, they spread out.	nature of a density wave	Explain nature of a density wave using an analogy. The analogy should be suitable for a business student.
Enzymes are like the machines in a factory. They are responsible for the production of products. In a business, enzymes would be responsible for producing the products that the company sells.	enzymes	Explain enzymes using an analogy. The analogy should be suitable for a business student.
Enzymes are like secretaries in a business. They help to speed up the process by doing some of the work for you.	enzymes	Explain enzymes using an analogy. The analogy should be suitable for a business student.
Enzymes can be thought of as workers in a factory. They are responsible for carrying out the specific tasks that keep the factory running smoothly. In the same way, enzymes are responsible for carrying out the specific tasks that keep our bodies functioning properly.	enzymes	Explain enzymes using an analogy. The analogy should be suitable for a business student.
The human active memory system is like a computer. The working memory, which is also known as the primary or active memory, is like the RAM in a computer. It holds information that you are currently using. The long-term memory is like the hard drive in a computer. It stores information that you have learned and accessed in the past.	human active memory system	Explain human active memory system using an analogy. The analogy should be suitable for a business student.
Active memory is a little bit like a personal assistant. It's always there to help you out when you need it, and it can store a lot of information for you so that you don't have to remember everything yourself. You can keep adding new things to your active memory as needed, and it will help you stay organized and efficient.	human active memory system	Explain human active memory system using an analogy. The analogy should be suitable for a business student.
The human active memory system can be compared to a computer's random access memory (RAM). The RAM is where the computer stores data that is actively being used. When the computer needs to access this data, it can do so quickly and easily. The human active memory works in a similar way. It stores information that is currently being used so that it can be accessed quickly and easily.	human active memory system	Explain human active memory system using an analogy. The analogy should be suitable for a business student.
The rate-determining step of a reaction is the slowest step in a chemical reaction. Just as with any business process, if you want to speed up the overall reaction, you need to work on speeding up that slowest step. This analogy can be helpful for thinking about how to improve efficiency in any process—chemical or otherwise.	rate-determining step of a reaction	Explain rate-determining step of a reaction using an analogy. The analogy should be suitable for a business student.
The rate-determining step of a reaction is the slowest step in the reaction. The analogy for this would be if you are trying to move a couch across the room and it is too heavy, then no matter how many people you have helping, it will take a long time to move because that one person has to do all the work moving the couch.	rate-determining step of a reaction	Explain rate-determining step of a reaction using an analogy. The analogy should be suitable for a business student.
One analogy for the rate-determining step of a reaction is to think of it as the speed at which your car can go on a certain road. The rate-determining step would be like finding out what the speed limit is on that road. If you want to go faster, you need to find a way to get around that speed limit.	rate-determining step of a reaction	Explain rate-determining step of a reaction using an analogy. The analogy should be suitable for a business student.
Column chromatography is like a funnel. The smaller particles are at the top of the column and the larger particles are at the bottom.	column chromatography	Explain column chromatography using an analogy. The analogy should be suitable for a business student.
Column chromatography is similar to sorting mail at the post office. The different colors of ink on an envelope (the compounds) can be separated by running the envelope through a series of filters with different colors. In column chromatography, the compounds are dissolved in a solvent and passed through a column packed with tiny pieces of material called adsorbents. Each type of compound will stick to a particular kind of adsorbent, allowing it to be separated from the other compounds.	column chromatography	Explain column chromatography using an analogy. The analogy should be suitable for a business student.
Column chromatography is like sorting a deck of cards. The cards are placed in a column and different colors are pulled out one at a time.	column chromatography	Explain column chromatography using an analogy. The analogy should be suitable for a business student.
Dynamic chemical equilibrium is a bit like a well-oiled business machine. The individual pieces (molecules) are constantly in motion, but the overall system is stable and productive. When something disrupts the balance (a new molecule enters the mix, for example), the molecules will reorganize themselves until equilibrium is restored.	dynamic chemical equilibrium	Explain dynamic chemical equilibrium using an analogy. The analogy should be suitable for a business student.
Dynamic chemical equilibrium can be thought of as a business that is always in flux, with new products and services being created while others are discontinued. The company strives to maintain a balance between its income and expenses so that it can continue to operate successfully. In the same way, the concentrations of chemicals in a solution reach a dynamic equilibrium as they react and interact with one another.	dynamic chemical equilibrium	Explain dynamic chemical equilibrium using an analogy. The analogy should be suitable for a business student.
Dynamic chemical equilibrium can be thought of as a market in which the demand for and supply of a particular product are always in balance. In this analogy, the product is chemical equilibrium and the buyers are chemical species (molecules or atoms). The sellers are the elements that make up these molecules or atoms. Just as in any other market, if there is an imbalance between the amount of a product that people want to buy and the amount that is available for sale, either the price will go up until equilibrium is reached or some of the buyers will go without.	dynamic chemical equilibrium	Explain dynamic chemical equilibrium using an analogy. The analogy should be suitable for a business student.
A vacuole can be thought of as a storage container in the business world. It is used to store items or materials that are not currently needed. This can help to free up space elsewhere in the business and make it more organized.	vacuole	Explain vacuole using an analogy. The analogy should be suitable for a business student.
A vacuole can be thought of as an individual's "spare change" purse. It is a place where the individual stores money that is not currently needed, but may be needed in the future. In the same way, a vacuole stores extra water and other resources that a cell may need at some point in the future.	vacuole	Explain vacuole using an analogy. The analogy should be suitable for a business student.
A vacuole can be thought of as a storage area in a business. It is used to store items that are not currently being used, but may be needed in the future. The vacuole is like a closet or cabinet where you can put away your clothes until you need them again.	vacuole	Explain vacuole using an analogy. The analogy should be suitable for a business student.
The transport vesicles are like the mailroom in a business. The mailroom receives all of the letters and packages for the business and then distributes them to the appropriate departments. The transport vesicles do the same thing for molecules within the cell. They receive all of the molecules and then distribute them to the appropriate parts of the cell.	transport vesicles	Explain transport vesicles using an analogy. The analogy should be suitable for a business student.
A transport vesicle can be thought of as a small truck that delivers goods from one part of the company to another. The truck picks up goods from one location and drops them off at another, making it faster and easier for employees to move around the company. Like a transport vesicle, a business truck makes it easier for workers to do their job by moving goods quickly and efficiently between different parts of the company.	transport vesicles	Explain transport vesicles using an analogy. The analogy should be suitable for a business student.
If transport vesicles were a business, they would be the equivalent of FedEx or UPS. They are responsible for getting goods from one place to another as quickly and efficiently as possible. In the case of transport vesicles, these "goods" are proteins and other molecules that need to be delivered to specific parts of the cell.	transport vesicles	Explain transport vesicles using an analogy. The analogy should be suitable for a business student.
Proto-oncogenes are like small businesses that have the potential to grow into big businesses. They may not be very profitable at first, but they have the potential to become major players in their industry. Oncogenes are like large businesses that have already achieved a lot of success. They may be more profitable than proto-oncogenes, but they also have a higher risk of failure.	proto-oncogenes	Explain proto-oncogenes using an analogy. The analogy should be suitable for a business student.
Proto-oncogenes are like the sales department of a company. They promote tumor growth by encouraging cells to divide and spread.	proto-oncogenes	Explain proto-oncogenes using an analogy. The analogy should be suitable for a business student.
A proto-oncogene is like a regular gene, except that it has the potential to cause cancer. It's sort of like a car with the potential to become a deadly weapon. The car itself isn't dangerous, but if someone were to steal it and use it to run people over, it would be very harmful. In the same way, a proto-oncogene can cause cancer if it's mutated and starts dividing out of control.	proto-oncogenes	Explain proto-oncogenes using an analogy. The analogy should be suitable for a business student.
Oncogenes are like viruses in a business. They can infect healthy cells and turn them into cancerous cells.	oncogenes	Explain oncogenes using an analogy. The analogy should be suitable for a business student.
Oncogenes are like a business that is doing well and is making money. The oncogene makes the cells in the body grow and divide rapidly, which is good for the business because it means more products (cells) are being made. However, if something goes wrong with the oncogene or the company that owns it, things can quickly spiral out of control and result in cancer.	oncogenes	Explain oncogenes using an analogy. The analogy should be suitable for a business student.
Oncogenes are like viruses in a business. They can infect healthy cells and turn them into cancerous cells.	oncogenes	Explain oncogenes using an analogy. The analogy should be suitable for a business student.
Tumor suppressor genes can be thought of as the quality control department for a business. They are responsible for making sure that all cells in the body are functioning properly and that any abnormal growths, or tumors, are detected and dealt with quickly. Like any good quality control department, tumor suppressor genes work tirelessly to keep things running smoothly so that the business can thrive.	tumor suppressor genes	Explain tumor suppressor genes using an analogy. The analogy should be suitable for a business student.
A tumor suppressor gene is like a security guard in a business. The security guard's job is to protect the business from criminals and vandals. If the security guard fails to do his job, the criminals and vandals can cause damage to the business. Similarly, if a tumor suppressor gene fails to do its job, tumors can form and damage the body.	tumor suppressor genes	Explain tumor suppressor genes using an analogy. The analogy should be suitable for a business student.
Tumor suppressor genes can be thought of as the quality control department for a company. They make sure that mistakes (cancer) do not occur and that cells are functioning properly.	tumor suppressor genes	Explain tumor suppressor genes using an analogy. The analogy should be suitable for a business student.
If software is brittle, it means that it breaks easily and requires a lot of maintenance. A good analogy for brittle software would be something like old, rusty metal. It might still work, but it's prone to breaking and needs a lot of extra care in order to stay operational.	brittle software	Explain brittle software using an analogy. The analogy should be suitable for a business student.
 brittle software is like a glass figurine. It looks delicate and beautiful from a distance, but it's actually quite fragile. If you touch it or bump into it, it might shatter into pieces.	brittle software	Explain brittle software using an analogy. The analogy should be suitable for a business student.
Software can be seen as a brittle and delicate object. Just like when you drop something fragile, it might break or shatter, the same can happen to software when it's subjected to too much stress or pressure. This is why software needs to be handled with care, just like any other valuable business asset.	brittle software	Explain brittle software using an analogy. The analogy should be suitable for a business student.
Resonance hybrid can be analogized to a successful business. In both cases, there is a careful balance of elements (components/resources) that must be maintained in order for the system to thrive. Too much or too little of any one element can destabilize the system and lead to failure. In addition, each component/resource must be used efficiently and effectively in order to generate the most value for the collective whole.	resonance hybrid	Explain resonance hybrid using an analogy. The analogy should be suitable for a business student.
Think of resonance hybrid as a team of experts in different fields who come together to create something special. Each expert brings their own knowledge and skills to the table, and by working together they are able to create something that is far greater than the sum of its parts.	resonance hybrid	Explain resonance hybrid using an analogy. The analogy should be suitable for a business student.
A resonance hybrid is like a balance beam. It has two very heavy weights on one side and two light weights on the other. The heavy weights are the electron pairs in the oxygen atom, and the light weights are the electron pairs in the nitrogen atom. The nitrogen atom's electrons can move back and forth along the beam very easily, but the oxygen atom's electrons are much more stuck in place. So when you push down on one end of the beam, all of the weight moves to that end, but when you let go it swings back to where it started because of all of that movement from the nitrogen atoms' electrons.	resonance hybrid	Explain resonance hybrid using an analogy. The analogy should be suitable for a business student.
A wave mechanical model can be thought of as a big ocean wave. The water at the top of the wave is moving quickly, while the water at the bottom is barely moving at all. This analogy can be used to explain how waves move through a material. A material will vibrate quickly at the surface (the top of the wave), and slowly near the bottom.	wave mechanical model	Explain wave mechanical model using an analogy. The analogy should be suitable for a business student.
A wave mechanical model can be thought of as a group of people who are all standing in line and holding hands. When one person moves, the whole line moves with them. In the same way, when an electron in an atom moves, it causes the other electrons in the atom to move with it.	wave mechanical model	Explain wave mechanical model using an analogy. The analogy should be suitable for a business student.
A wave mechanical model can be thought of as a group of people walking in a synchronized fashion. Just as the individuals in the group create waves of movement that pass through them, so too do the molecules in a substance create waves of movement that pass through them. The faster someone walks, the more quickly the wave passes through them. Similarly, when something is heated, its molecules move faster and thus create waves that pass through them more quickly.	wave mechanical model	Explain wave mechanical model using an analogy. The analogy should be suitable for a business student.
The electroencephalogram can be thought of as a map of the brain's electrical activity. Just like businesses need maps to help them find their way around, doctors use EEGs to see how different parts of the brain are working.	electroencephalogram	Explain electroencephalogram using an analogy. The analogy should be suitable for a business student.
The analogy of an EEG is that it is like a car's dashboard. It gives you information about what is going on inside the car while you are driving. The EEG does the same thing for your brain - it tells you what is happening in your brain while you are thinking or performing other activities.	electroencephalogram	Explain electroencephalogram using an analogy. The analogy should be suitable for a business student.
The analogy could be between the brain and a computer. The electroencephalogram is like the read out of the computer, telling us what is going on inside the brain.	electroencephalogram	Explain electroencephalogram using an analogy. The analogy should be suitable for a business student.
DNA replication is a bit like making a copy of a document. The DNA molecule is the original, and the copies are the new documents.	dna replication	Explain dna replication using an analogy. The analogy should be suitable for a business student.
DNA replication is like a copy machine. The original document is placed on the glass plate and the copy machine makes a duplicate of the document.	dna replication	Explain dna replication using an analogy. The analogy should be suitable for a business student.
DNA replication can be thought of as a photocopier. The DNA molecule is like the original document, and the copies are the photocopies.	dna replication	Explain dna replication using an analogy. The analogy should be suitable for a business student.
In business, an individual might be hired as an employee to do a specific job. The individual's responsibilities are spelled out in a job description. This document serves as a guide for the employer and the employee alike, outlining what is expected of the employee and what benefits they can expect in return.Similarly, rna transcription occurs when a section of dna is read by enzymes called ribozymes. These enzymes follow the instructions found in the dna sequence to create a new strand of rna. Just as a job description outlines expectations and duties for an employee, the dna sequence provides information that determines how new strands of rna will be assembled.	rna transcription	Explain rna transcription using an analogy. The analogy should be suitable for a business student.
RNA transcription is a bit like making copies of a document. The original document is the DNA, and the copies are the RNA.	rna transcription	Explain rna transcription using an analogy. The analogy should be suitable for a business student.
The process of RNA transcription can be likened to the process of a business making copies of important documents. The original document is like the DNA, and the copies are like the RNA. Just as businesses need a copier in order to make multiple copies of documents, cells need an enzyme called RNA polymerase in order to make multiple copies of DNA molecules.	rna transcription	Explain rna transcription using an analogy. The analogy should be suitable for a business student.
Protein translation is a bit like making a cake. Just as you need flour, sugar, eggs and butter to make a cake, your body needs different types of protein to build muscles, skin and organs. The recipe for each type of protein is written out in DNA (the genetic code), just as the recipe for each type of cake is written down in a cookbook. To make the cake (or proteins), special machines called ribosomes read the recipe from DNA and use it to assemble chains of amino acids (the ingredients).	protein translation	Explain protein translation using an analogy. The analogy should be suitable for a business student.
Let's say you're the CEO of a company. You have a message that you want to get out to your employees, but you can't just yell it across the room - they need to be able to read it. So, you write down the message on a sheet of paper and put it in an envelope. You give the envelope to your assistant, who takes it across the room and hands it to one of your employees. The employee opens up the envelope, pulls out the sheet of paper, and reads what you wrote. Then, they take action based on your message.This is basically how protein translation works. The genetic code is like the message written down on paper, while ribosomes are like your assistant taking it across the room and handing it to an employee. The employee is called tRNA (transfer RNA), and they "read" the genetic code and use it to build a protein molecule based on instructions from mRNA (molecular messenger RNA).	protein translation	Explain protein translation using an analogy. The analogy should be suitable for a business student.
 Protein translation is the process of creating a protein molecule from an mRNA sequence. This can be likened to a business translating a foreign language document into English so that it can be understood by its employees. The mRNA is like the original document, and the resulting protein is like the translated document.	protein translation	Explain protein translation using an analogy. The analogy should be suitable for a business student.
An ecosystem can be thought of as a complex business network. The different parts of the ecosystem (such as producers, consumers, and decomposers) interact with one another to create a balanced system in which all the elements are necessary for the whole to function. In order for a business to thrive, it needs to have a strong network of suppliers and customers who interact with each other to create value. Just like in an ecosystem, if any part of the business network is disrupted or removed, the whole system can collapse.	ecosystem	Explain ecosystem using an analogy. The analogy should be suitable for a business student.
The ecosystem of a business is like the environment of an animal. The company is the animal, and its customers, suppliers, partners, and competitors are all part of its environment. The company's products and services are like the food that it eats, and the money it makes is like the air it breathes.	ecosystem	Explain ecosystem using an analogy. The analogy should be suitable for a business student.
An ecosystem is like a business. The different parts of the ecosystem (in this analogy, the different departments of a company) all work together to keep things running smoothly and create an environment where success can thrive. Just as each department in a company has its own specific role to play, each component of an ecosystem has an important job to do in order for the system as a whole to function properly.	ecosystem	Explain ecosystem using an analogy. The analogy should be suitable for a business student.
A business student might understand the propagation of an action potential down a neuron using the analogy of an electric current traveling down a wire. Just as electricity travels down a wire more easily when the wire is in good condition, so too does the electric current travel down a neuron more easily when the neuron is healthy. Damaged or unhealthy neurons may not be able to carry an action potential very far, which can impair communication between different parts of the brain.	propagation of an action potential down a neuron	Explain propagation of an action potential down a neuron using an analogy. The analogy should be suitable for a business student.
The action potential can be thought of as an email. The "sender" is the neuron's cell body and the "receiver" is the synapse. The neurotransmitters are like the email's subject line and content. When the sender (cell body) sends an impulse down its axon, it creates a tiny electrical current. This current travels down to the end of the axon where it triggers a release of neurotransmitters into the synaptic cleft. The neurotransmitters diffuse across the gap and attach to receptor sites on the receiving neuron's membrane. This causes changes in electric charge that propagate along the surface of the neuron, eventually triggering another action potential at that neuron's synapse with yet another neuron	propagation of an action potential down a neuron	Explain propagation of an action potential down a neuron using an analogy. The analogy should be suitable for a business student.
When someone sends an email, it starts at the person's computer and travels through the internet to the recipient's computer. An action potential in a neuron is similar - it starts at the neuron's cell body and travels down its axon to its terminals.	propagation of an action potential down a neuron	Explain propagation of an action potential down a neuron using an analogy. The analogy should be suitable for a business student.
Lungs are like a car's gas tank. The frog breathes in through its nose, and the air goes into its lungs. The lungs are like a balloon that gets bigger and smaller as the frog breathes in and out. When the frog exhales, it pushes all of the carbon dioxide out of its lungs.	breathing mechanism of frogs	Explain breathing mechanism of frogs using an analogy. The analogy should be suitable for a business student.
Breathing in frogs is similar to a person inhaling. The lungs fill up with air and the diaphragm contracts, pushing down on the stomach and forcing the air into the lungs. When you exhale, your stomach muscles push the air out of your lungs. Frogs use their ribs to help them breathe. They can inflate their ribcage when they take a breath in and deflate it when they breathe out, which helps them get more air into their lungs.	breathing mechanism of frogs	Explain breathing mechanism of frogs using an analogy. The analogy should be suitable for a business student.
Breathing in frogs is a little bit like how a vacuum cleaner works. The frog's lungs are like the bag of the vacuum cleaner and when they suck in air, it goes into their lungs. Then, when they push out the air, it goes back out of their body through their nose.	breathing mechanism of frogs	Explain breathing mechanism of frogs using an analogy. The analogy should be suitable for a business student.
The analogy of layered architecture is the construction of a building. The foundation is the first layer, and it is important because it provides stability for the rest of the building. The walls, ceilings, and floors are the next layers, and they provide structure and support for people and objects inside the building. Finally, the roof protects everyone and everything in the building from weather conditions outside.	layered architecture	Explain layered architecture using an analogy. The analogy should be suitable for a business student.
A layered architecture can be thought of as an onion. The outside layer is the easiest to access and the inside layer is the most difficult. Each layer represents a different level of abstraction.	layered architecture	Explain layered architecture using an analogy. The analogy should be suitable for a business student.
A layered architecture is like having a layer cake. Each layer is built on top of the other, and each has a specific purpose. The bottom layer is the foundation, and it supports the weight of the upper layers. The next layer up is the frosting, which makes the cake look pretty and adds flavor. The third layer is made up of all of the different flavors of cake, such as chocolate, vanilla, and strawberry. Finally, the topmost layer is decorated with sprinkles or icing.	layered architecture	Explain layered architecture using an analogy. The analogy should be suitable for a business student.
A limiting reactant is like a scarce resource in the business world. For example, let's say your company wants to produce 100 widgets using two different resources: tin and copper. If the company has only 50 pounds of tin, it will be able to make only 50 widgets. Even if the company has 500 pounds of copper, it will still only be able to make 50 widgets because there is not enough tin to go around. In this analogy, tin would be the limiting reactant and copper would be the excess reactant.	limiting reactant and excess reactant	Explain limiting reactant and excess reactant using an analogy. The analogy should be suitable for a business student.
One way to think about limiting and excess reactants is in terms of a business. Imagine that you own a bakery and are making 1000 cookies. You need flour, sugar, eggs, butter, and baking powder to make the cookies. The recipe for the cookies calls for 1 cup of each ingredient. If you only have 500 cups of each ingredient, then you will only be able to make 500 cookies because that is all the ingredients you have. The flour is the limiting reactant because it is being used up first in the reaction. The sugar, eggs, butter, and baking powder are all excess reactants because they are not being used up in the reaction.	limiting reactant and excess reactant	Explain limiting reactant and excess reactant using an analogy. The analogy should be suitable for a business student.
One way to think about it is that a limiting reactant is like a scarce resource, while an excess reactant is like unlimited resources. For example, imagine your company has only one factory and it can produce 100 widgets per day. If demand for widgets exceeds production capacity (100 widgets/day), then the factory will run out of widgets by the end of the day- this would be analogous to a limiting reactant scenario. On the other hand, if your company had two factories and each could produce 200 widgets per day, then meeting demand for 300 widgets/day would be analogous to an excess reactant scenario.	limiting reactant and excess reactant	Explain limiting reactant and excess reactant using an analogy. The analogy should be suitable for a business student.
The cell is like a small business. The nucleus is the CEO, and the mitochondria are the workers. The cytoplasm is the office space, and the plasma membrane is the door.	eukaryotic cell	Explain eukaryotic cell using an analogy. The analogy should be suitable for a business student.
A eukaryotic cell can be thought of as a small business. The nucleus is the CEO, while the mitochondria are the workers. The plasma membrane is the fence around the property and the cytoplasm is the grounds.	eukaryotic cell	Explain eukaryotic cell using an analogy. The analogy should be suitable for a business student.
A eukaryotic cell is a bit like a small business. It has a CEO (the nucleus), managers (the organelles), and employees (the cytoplasm). The CEO sets the goals for the company and oversees everything, while the managers are responsible for specific functions within the company, such as marketing or accounting. And finally, the employees do the actual work to make the company successful.	eukaryotic cell	Explain eukaryotic cell using an analogy. The analogy should be suitable for a business student.
A prokaryotic cell could be compared to a small business. The prokaryotic cell is the owner of the small business and it has complete control over all aspects of the company. The prokaryotic cell can make decisions about what products or services to offer, how to market them, and who to hire/fire. It also oversees production and handles all financial transactions.	prokaryotic cell	Explain prokaryotic cell using an analogy. The analogy should be suitable for a business student.
A prokaryotic cell is like a small business. The cell has a limited amount of resources and it needs to use them efficiently in order to survive. It also needs to be able to respond quickly to changes in its environment.	prokaryotic cell	Explain prokaryotic cell using an analogy. The analogy should be suitable for a business student.
A prokaryotic cell can be thought of as a small business. The cell has a CEO (the nucleus), workers (ribosomes), and customers (other cells). The CEO is in charge of the workers, who produce products for the customers.	prokaryotic cell	Explain prokaryotic cell using an analogy. The analogy should be suitable for a business student.
The analogy is of the kernel as the brains of a computer. The kernel controls everything that happens on the computer and manages all the resources. It allocates memory, handles input and output, runs programs and organizes files. Just like how a human brain coordinates all the activities of the body, so too does the kernel coordinate all the activities of a computer system.	operating systems kernel	Explain operating systems kernel using an analogy. The analogy should be suitable for a business student.
The analogy should be suitable for a business student.A kernel is the innermost part of a nut. It's hard, protects the nut's contents, and is surrounded by a softer layer. In computing, the kernel is the most fundamental component of an operating system. Just as the kernel is essential to protect the nut's contents, so too is the kernel essential to protect an operating system's data and devices. The kernel forms a foundation upon which all other functions and applications are built.	operating systems kernel	Explain operating systems kernel using an analogy. The analogy should be suitable for a business student.
A kernel is the brains of a computer. It manages all the basic functions of the machine and ensures that everything runs smoothly. In a business, the kernel would be responsible for managing payroll, accounting, and other essential operations.	operating systems kernel	Explain operating systems kernel using an analogy. The analogy should be suitable for a business student.
A limiting reactant is like a worker who is only able to do a certain amount of work in a day. The other reactants are like the workers who can help do the work, but they need the limiting reactant to finish the job.	limiting reactant	Explain limiting reactant using an analogy. The analogy should be suitable for a business student.
A limiting reactant can be thought of as the "bottleneck" in a production process. Just like a real bottleneck can limit the amount of product that can be produced, a limiting reactant can limit the amount of chemical reaction that can occur. In other words, if you have too much of one reactant and not enough of another, the first reactant will become the limiting reactant.	limiting reactant	Explain limiting reactant using an analogy. The analogy should be suitable for a business student.
One way to think about a limiting reactant is as a scarce resource in a factory. In this analogy, the reactants are workers, and the products are the things they produce. The limiting reactant is the worker who can't keep up with the demand for products- he's running out of resources (time) to produce them.	limiting reactant	Explain limiting reactant using an analogy. The analogy should be suitable for a business student.
Helicase can be compared to a forklift. It is responsible for moving cargo (nucleotides) around in the cell and helping to create new DNA strands.	helicase	Explain helicase using an analogy. The analogy should be suitable for a business student.
Helicase is a bit like the gears in a car. Just as the gears need to be well oiled and working properly for the car to run smoothly, helicase needs to be lubricated and functioning correctly for DNA replication to take place.	helicase	Explain helicase using an analogy. The analogy should be suitable for a business student.
Helicase can be thought of as a taxi driver. The driver is responsible for getting passengers from point A to point B. In the same way, helicase helps DNA strands move around and interact with other proteins.	helicase	Explain helicase using an analogy. The analogy should be suitable for a business student.
A replication binding protein is like a secretary. The secretary's job is to help organize and keep track of the office's resources, making sure that everything runs smoothly. In the same way, replication binding proteins help keep track of the DNA strands during replication, organizing them so that duplication can occur correctly.	dna replication binding proteins	Explain dna replication binding proteins using an analogy. The analogy should be suitable for a business student.
Replication binding proteins are like the glue that binds two pieces of paper together. Just as the adhesive holds the paper together, the replication binding proteins keep DNA together as it is replicated.	dna replication binding proteins	Explain dna replication binding proteins using an analogy. The analogy should be suitable for a business student.
DNA replication binding proteins can be thought of as the glue that holds DNA together. They help to keep the strands of DNA together and ensure that the right pieces are copied properly during replication. Without these proteins, DNA would fall apart and be unable to replicate.	dna replication binding proteins	Explain dna replication binding proteins using an analogy. The analogy should be suitable for a business student.
Ligase can be thought of as a “glue” that helps to hold together two DNA strands. Just as glue can help to hold together different pieces of paper, ligase helps to hold together the two DNA strands.	ligase	Explain ligase using an analogy. The analogy should be suitable for a business student.
If you think of enzymes as tiny workers, then ligases are the foremen. They direct the work that needs to be done and make sure everything is running smoothly. Just like a good foreman, ligases keep track of all the little details so that everything comes together in the end.	ligase	Explain ligase using an analogy. The analogy should be suitable for a business student.
Ligase can be thought of as the glue that binds two pieces of paper together. Just as ligase joins two pieces of paper, it also helps to join DNA strands together. This process is important for repairing damaged DNA and creating new DNA sequences.	ligase	Explain ligase using an analogy. The analogy should be suitable for a business student.
A process control block (PCB) is a collection of data that is used to manage a process. The data in the PCB can be used to make decisions about how to optimize the process. The PCB can also be used to track the progress of the process and identify any problems that may occur.	process control block	Explain process control block using an analogy. The analogy should be suitable for a business student.
A process control block (PCB) can be thought of as an imaginary box that surrounds and oversees a specific business process. The PCB contains all the important information needed to manage and monitor the process, such as performance goals, targets, and measurements. Any changes or updates to the process must be made in the PCB first, ensuring that any modifications do not disrupt or negatively affect the overall function of the business process.	process control block	Explain process control block using an analogy. The analogy should be suitable for a business student.
A control block is like the steering wheel of a car. It allows the driver to direct the car where they want it to go. In a business, the control block is like the CEO or manager. They are responsible for directing the company in the right direction.	process control block	Explain process control block using an analogy. The analogy should be suitable for a business student.
When you send a message, you are encoding it into a format that can be read by the receiver. This is analogous to sending an email in English instead of Spanish - the recipient will be able to understand the message without any special software or knowledge.	message encoding	Explain message encoding using an analogy. The analogy should be suitable for a business student.
Message encoding is like translating a message from one language to another. The translator must understand the grammar and vocabulary of both languages in order to accurately translate the message.	message encoding	Explain message encoding using an analogy. The analogy should be suitable for a business student.
Let's say you're traveling to another country and need to tell your friend back home about all the amazing things you did. You could write a long letter, but it would be much easier to use a phone. When you talk on the phone, your voice is converted into electrical signals that are sent over wires to your friend's house. Your friend's phone converts the electrical signals back into sound so they can hear what you're saying.	message encoding	Explain message encoding using an analogy. The analogy should be suitable for a business student.
One could think of drug-receptor interactions as being a bit like two businesspeople trying to make a deal. The drug is the businessman and the receptor site is the potential customer. In order for either party to agree to do business together, they first need to meet and get to know each other. This process is known as binding. Once they have met and decided that they want to work together, the next step is negotiation in order to come up with an agreement that works for both parties. This analogy can be further broken down into four steps:1) Binding: Just as two people need to physically meet before they can negotiate a deal, so too do drugs and receptor sites need to bind (or attach) together in order for any interaction between them to take place. This binding process occurs when the drug molecule attaches itself onto the receptor site on the surface of cells.2) Activation: After binding has taken place, it's then necessary for one or both parties involved in negotiations (in this case, the drug and receptor site) to activate each other. In most cases, it's the drug that activates receptors by sending out specific signals that tell them what kind of activity they should start carrying out.3) Response: Once activated, receptors will go about performing whatever function has been asked of them by the drug molecule. This may include releasing certain chemicals or hormones, changing how other proteins are behaving inside cells, or even destroying cells altogether.4) Termination: Finally, after doing their job(s), receptors usually terminate their activities by breaking down or getting recycled back into cell membranes.	interaction between drugs and receptor sites	Explain interaction between drugs and receptor sites using an analogy. The analogy should be suitable for a business student.
One analogy for the interaction between drugs and receptor sites is that of a lock and key. The drug is the key, and the receptor site is the lock. When the key (drug) fits into the lock (receptor site), it opens up and allows something to happen, such as a message being sent.	interaction between drugs and receptor sites	Explain interaction between drugs and receptor sites using an analogy. The analogy should be suitable for a business student.
 suppose that you are the manager of a small business. your company manufactures and sells widgets. one day, you learn that a new competitor has entered the market and is selling widgets at a lower price than you do. what can you do to stay competitive?one option would be to lower your prices. another option would be to find ways to make your widgets more appealing to customers. for example, you could improve the quality of your widgets or offer additional features or services.	interaction between drugs and receptor sites	Explain interaction between drugs and receptor sites using an analogy. The analogy should be suitable for a business student.
A monitor is like a window into your business. It allows you to see what is happening in real-time, and helps you make better decisions based on that information.	monitor	Explain monitor using an analogy. The analogy should be suitable for a business student.
A monitor is like the dashboard of a car. It provides information about what is happening with the vehicle and allows the driver to make changes as needed. A business student might think of a monitor as a way to track financial data, sales figures, or other important metrics.	monitor	Explain monitor using an analogy. The analogy should be suitable for a business student.
A monitor is like a supervisor in a business. They are responsible for overseeing the work that is done, ensuring that it is completed correctly and on time. They also provide support and guidance to employees as needed.	monitor	Explain monitor using an analogy. The analogy should be suitable for a business student.
A CPU is like a worker in a factory. The worker gets directions from the boss (the program) and starts working on the task at hand. While the worker is working, they are constantly looking for new tasks to do (other instructions).	cpu	Explain cpu using an analogy. The analogy should be suitable for a business student.
One way to think of a CPU is as the brain of a computer. Just as the human brain controls all the functions of the body, so too does the CPU control all the functions of a computer. The CPU handles things like reading and writing data to memory, running programs, and managing peripherals.	cpu	Explain cpu using an analogy. The analogy should be suitable for a business student.
A CPU can be thought of as an office worker. The office worker's job is to complete tasks that are assigned to them. The CPU completes the tasks that are assigned to it by the software that is running on the computer.	cpu	Explain cpu using an analogy. The analogy should be suitable for a business student.
The motherboard is the foundation of a computer. It holds all of the essential components and allows them to communicate with each other. The motherboard is like the central nervous system of a computer, coordinating everything that happens inside.	motherboard	Explain motherboard using an analogy. The analogy should be suitable for a business student.
A motherboard can be thought of as a company’s organizational chart. It shows the different levels of management, and how they are related to each other. It also shows the different departments within the company, and how they are related to each other.	motherboard	Explain motherboard using an analogy. The analogy should be suitable for a business student.
A motherboard can be thought of as the brain of a computer. It houses all of the key components that allow the computer to function, including the CPU, memory, and storage. It also provides connections for input devices like keyboards and mice, output devices like monitors, and networking cables.	motherboard	Explain motherboard using an analogy. The analogy should be suitable for a business student.
Ram is like a computer's temporary working memory. When the computer is turned on, it loads its operating system and other software from the hard drive into RAM. This allows the computer to access this information quickly and run programs. RAM is also used to store data that is being processed by a program. When the program ends, the data is usually deleted from RAM.	ram	Explain ram using an analogy. The analogy should be suitable for a business student.
Ram is like a hard drive in that it is used to store data. However, unlike a hard drive, ram is volatile which means that once power is removed the data will be lost. Ram also tends to be faster than a hard drive.	ram	Explain ram using an analogy. The analogy should be suitable for a business student.
Ram can be thought of as an office worker who is always up for doing more work. He is always on the lookout for new tasks to take on, and he never hesitates to jump in and help out. Ram is always productive and motivated, which makes him a valuable member of any team.	ram	Explain ram using an analogy. The analogy should be suitable for a business student.
A power supply unit can be thought of as the batteries in a toy car. Just as the battery powers the toy car, a power supply unit powers a computer. The power supply converts standard AC voltage from the wall into DC voltage that is needed by the computer.	power supply unit	Explain power supply unit using an analogy. The analogy should be suitable for a business student.
A power supply unit can be thought of as the engine that powers a company's operations. Just like an engine needs fuel to run, a power supply unit needs electricity to function. The power supply unit takes electricity from the grid and converts it into a form that is usable by computers and other electronics. It then regulates and distributes that power to where it is needed in the company.	power supply unit	Explain power supply unit using an analogy. The analogy should be suitable for a business student.
The power supply unit is the heart of a computer. It takes AC power from the wall outlet and converts it to DC power that the computer can use. The PSU also has fans to keep it cool, and connectors for attaching drives, fans, and other devices.	power supply unit	Explain power supply unit using an analogy. The analogy should be suitable for a business student.
A keyboard is like a telephone keypad. Just as you would press the 2 button on a phone to call someone with that number, you would press the "2" key on a keyboard to type that letter.	keyboard	Explain keyboard using an analogy. The analogy should be suitable for a business student.
Think about a keyboard as an office assistant. The keyboard is always there to help you out and make your work easier. It's always available when you need it and is quick to respond. Plus, it knows all the shortcuts to get things done quickly!	keyboard	Explain keyboard using an analogy. The analogy should be suitable for a business student.
The keyboard is like a telephone keypad. Just as you would dial a phone number by pressing the keys on the phone, you type text by pressing the keys on the keyboard.	keyboard	Explain keyboard using an analogy. The analogy should be suitable for a business student.
A mouse is like a fast, small car. It's easy to move around and can get you where you want to go quickly.	mouse	Explain mouse using an analogy. The analogy should be suitable for a business student.
A mouse is like a secretary. The mouse helps you move around your computer and select different things to do or look at.	mouse	Explain mouse using an analogy. The analogy should be suitable for a business student.
When you use a mouse on your computer, it is like when you use a joystick to control the movement of an airplane. The mouse moves the cursor around on the screen, and when you click or double-click on something, it is like pressing a button on the joystick to make the airplane move in that direction.	mouse	Explain mouse using an analogy. The analogy should be suitable for a business student.
The audio card is like the shipping department for a company. It handles all of the shipments coming in and going out, making sure that everything arrives on time and in the right place.	audio card	Explain audio card using an analogy. The analogy should be suitable for a business student.
An audio card is like a salesperson. It helps to create and deliver the message to the customer.	audio card	Explain audio card using an analogy. The analogy should be suitable for a business student.
An audio card can be thought of as a translator. It takes the digital information that is encoded on a CD or other storage device and turns it into an analog signal that can be heard through a speaker.	audio card	Explain audio card using an analogy. The analogy should be suitable for a business student.
A video card can be thought of as a type of printer. Just like a normal printer, a video card prints out images on paper. However, the images that are printed out by a video card are displayed on a computer screen instead of being put onto paper.	video card	Explain video card using an analogy. The analogy should be suitable for a business student.
A video card is like a printer for computers. Just as printers allow you to create physical copies of documents, video cards let your computer create visual representations of digital information. This information can come in the form of text, images, or videos, and it can be used for anything from creating presentations and reports to watching movies or playing games.	video card	Explain video card using an analogy. The analogy should be suitable for a business student.
A video card can be compared to a printer. Just as a printer prints out text and images from a computer, a video card takes the digital data from the CPU and turns it into pictures that can be displayed on a monitor.	video card	Explain video card using an analogy. The analogy should be suitable for a business student.
The tree's age calculation can be analogy to a human's lifespan. Just as humans are born, grow older, and eventually die, trees are planted (born), grow taller and wider over time, and eventually lose their leaves and branches (die). In both cases however, there is no precise way to determine when exactly an individual will reach each stage of life - it could happen anywhere within the range given for that particular demographic. So too with trees: we can estimate that a tree planted in 1990 is about 27 years old, but it's possible that the specific tree in question reached maturity somewhat earlier or later than that.	tree's age calculation	Explain tree's age calculation using an analogy. The analogy should be suitable for a business student.
A tree's age calculation is similar to the way a company calculates its years in business. The company starts with Year 1, and each year it adds one more year to its total. So, at Year 4, the company has been in business for four years.	tree's age calculation	Explain tree's age calculation using an analogy. The analogy should be suitable for a business student.
A tree's age calculation is like a company's accounting system. The tree has an initial value (birth), and it accumulates additions over time. These additions may be positive (new growth) or negative (debris, pests, diseases). At any point in time, the total value of the tree can be calculated by summing all the addition since birth.	tree's age calculation	Explain tree's age calculation using an analogy. The analogy should be suitable for a business student.
Glycolysis can be thought of as the process of producing energy by breaking down sugar molecules. In a similar way, a business can produce energy by breaking down sales and profit figures. The business analogy can be further refined by thinking of the sugar molecule as something like revenue, and the products of glycolysis (ATP, NADH, etc) as something like profits.	glycolysis	Explain glycolysis using an analogy. The analogy should be suitable for a business student.
Glycolysis is like a company that sells candy. The company buys sugar and other ingredients from suppliers, then makes the candy in its own factory. The company sells the candy to customers, who eat it and get energy from it.	glycolysis	Explain glycolysis using an analogy. The analogy should be suitable for a business student.
The process of glycolysis can be thought of as the production line in a factory. Glucose is like the raw materials that come into the factory, and pyruvate is like the finished product that comes out of the factory. Enzymes are like the workers in the factory who help to turn glucose into pyruvate.	glycolysis	Explain glycolysis using an analogy. The analogy should be suitable for a business student.
When light hits something, it can be either absorbed or scattered. If the light is absorbed, then it's gone and we can't see what was hit. If the light is scattered, then it reflects off of whatever it hit in all directions. Think of anti-stokes scattering as a way to scatter the light back in the opposite direction. This happens when something hits a particle that's already been scattering light in all directions. The new light scatters off of the old particles in the opposite direction, which pushes them back out and makes it easier to see whatever was hit.	anti-stokes scattering	Explain anti-stokes scattering using an analogy. The analogy should be suitable for a business student.
When light is scattered by small particles, it can be thought of as a group of people pushing their way through a crowded room. The people (light) that are traveling slowest (scattered light) are forced to the side by the people moving faster. This is similar to how light scatters when it encounters small particles in the air.	anti-stokes scattering	Explain anti-stokes scattering using an analogy. The analogy should be suitable for a business student.
When two people are talking at a business meeting, and one person speaks loudly, the sound waves created by that person's voice will be stronger than the sound waves created by the other person. This is because the loud speaker is creating more energy in their sound waves than the other person. When these sound waves hit someone's ear, it will be easier for the energy from the louder speaker's waves to push them out of the way then it will be for the energy from the quieter speaker's waves. This analogy can help explain how anti-stokes scattering works. The louder speaker in this analogy would represent a photon with more energy, while the quieter speaker would represent a photon with less energy. Just as it is easier for a louder conversation to overpower a quieter conversation at a business meeting, it is easier for photons with more energy to scatter photons with less energy during anti-stokes scattering.	anti-stokes scattering	Explain anti-stokes scattering using an analogy. The analogy should be suitable for a business student.
Stokes scattering is similar to light reflection in that it causes a change in the direction of waves. In stokes scattering, particles scatter waves depending on their size and mass. This analogy can be best explained with an example from the business world. Let's say you are the owner of a small business. You have worked hard to create a successful company and you want to keep it growing. To do this, you will need to attract new customers and keep them coming back for more. One way to do this is by implementing a good marketing strategy. You may also want to consider using stokes scattering to bring in new customers. Stokes scattering works by sending out tiny particles into the atmosphere that will then reflect or scatter waves of light (in our case, marketing messages) in all directions. This can help your business reach more people and ultimately increase sales	stokes scattering	Explain stokes scattering using an analogy. The analogy should be suitable for a business student.
Stokes scattering is like a group of people in a room throwing pieces of paper up into the air and watching them drift back down. The person who throws the paper up is like the light source, and the people in the room are like atoms or molecules in the material that scatters the light.	stokes scattering	Explain stokes scattering using an analogy. The analogy should be suitable for a business student.
A good analogy for stokes scattering is the movement of particles in a fluid. Imagine you have a jar of muddy water. If you shake the jar, the mud will move around and eventually settle back to the bottom. This is similar to what happens when light waves pass through a substance like glass. The light wave will cause particles (muddy water) to move around and then they will settle down again (like the mud at the bottom of your jar).	stokes scattering	Explain stokes scattering using an analogy. The analogy should be suitable for a business student.
The median lethal dose (LD50) is the amount of a toxin that kills 50% of the test population. It can be thought of as the poison's "dosage" or "strength." Imagine you are a business student who has been asked to develop a new product for your company. Your task is to create a deadly toxin that can kill any person who ingests it. You must ensure that the dosage is just right, so that only half of those who consume it will die. Anything more than the median lethal dose would be too powerful and could kill everyone, while anything less would not be potent enough to do its job.	median lethal dose	Explain median lethal dose using an analogy. The analogy should be suitable for a business student.
The median lethal dose is the amount of a toxin that will kill 50% of a population. This can be thought of as the "lethal dose" or "poison dose" for a particular substance. It is important to note that the median lethal dose does not mean that half of those exposed will die, but rather it is the dosage at which half of the test subjects died.	median lethal dose	Explain median lethal dose using an analogy. The analogy should be suitable for a business student.
The median lethal dose is the amount of a toxin that can kill 50% of the people who consume it. In other words, it's the dose that's deadly to half of those exposed to it. To put this in business terms, think about it as the point at which half of your customers would stop doing business with you.	median lethal dose	Explain median lethal dose using an analogy. The analogy should be suitable for a business student.
The universe can be likened to a large company. Just as the universe is composed of many smaller parts, a company is made up of many smaller divisions. Just as the planets and stars in the universe move in their own unique orbits, different parts of a company have their own individual functions. And finally, just as the universe has been around for billions of years, companies are often generational entities that endure for centuries.	universe	Explain universe using an analogy. The analogy should be suitable for a business student.
The universe can be likened to a business. Imagine that the universe is a large company with billions of employees (galaxies, stars, planets, etc). The company has a CEO who oversees everything and makes decisions for the good of the company. Employees work together to achieve goals and contribute their unique talents and skills to help the company succeed. Some employees are in management positions while others are in lower-level positions. The company has rules and regulations that must be followed in order for it to function effectively. There is also an organizational chart which outlines how different parts of the company are structured. Finally, just as businesses have budgets, the universe has limited resources which must be managed carefully	universe	Explain universe using an analogy. The analogy should be suitable for a business student.
The universe can be analogized to a business. The Big Bang was the company's inception, and over time, it has grown in size and complexity. The planets, stars, and other celestial objects are like the company's products and services. They vary in size, function, and value. Comets and asteroids are like financial risks - they may have high potential payoff but also carry substantial risk. Black holes are like the company's liabilities - they consume everything around them but don't produce anything themselves.	universe	Explain universe using an analogy. The analogy should be suitable for a business student.
Enzymes are like the workers in a factory. They do the important job of converting one substance into another. In a business analogy, enzymes would be the people who work on the production line and convert raw materials into products that can be sold to consumers.	enzyme mechanism	Explain enzyme mechanism using an analogy. The analogy should be suitable for a business student.
The enzyme is like a clerk in a business. The molecule that the enzyme works on is like a customer who comes into the store. The enzyme takes the molecule and helps to change it, just as the clerk would help a customer with their purchase.	enzyme mechanism	Explain enzyme mechanism using an analogy. The analogy should be suitable for a business student.
Enzyme mechanism is like a business. The enzyme is the company and the substrate is the customer. The product that the enzyme creates is the service that the company provides. The reaction occurs when the customer pays for the service.	enzyme mechanism	Explain enzyme mechanism using an analogy. The analogy should be suitable for a business student.
The analogy of anova is the analysis of a survey by breaking it down into smaller parts. This allows you to see how different groups responded to the questions on the survey.	anova	Explain anova using an analogy. The analogy should be suitable for a business student.
You have a product that you want to sell. You have two ways of selling it, online and in store. You set up an experiment to see which way is more effective. In your experiment, you have 10 people who buy the product online and 10 people who buy the product in store. You want to know if there is a difference between how well the product sells online and in store. To find out, you use anova.	anova	Explain anova using an analogy. The analogy should be suitable for a business student.
An ANOVA can be thought of as a statistical test that is used to determine if there is a significant difference between the means of two or more groups. It can be used to compare the means of two independent groups, or to compare the means of a single group before and after it has been subjected to some form of treatment. The test works by comparing the variability within each group with the variability between groups. If the variance between groups is greater than the variance within groups, then it can be concluded that there is a statistically significant difference between the means of those groups.	anova	Explain anova using an analogy. The analogy should be suitable for a business student.
A thermostat is like a human body. It has a set point, which is the temperature that it wants to be at. The thermostat also has sensors that can detect the temperature of the room and it will adjust the furnace or air conditioner to try and reach the desired temperature.	thermostat	Explain thermostat using an analogy. The analogy should be suitable for a business student.
A thermostat is like a boss. The boss tells the employees what to do and when to do it in order to keep the company running smoothly. The thermostat does the same thing for your house by telling the furnace and air conditioner what to do in order to keep you comfortable.	thermostat	Explain thermostat using an analogy. The analogy should be suitable for a business student.
A thermostat is like a boss. It sets the temperature and makes sure it stays consistent.	thermostat	Explain thermostat using an analogy. The analogy should be suitable for a business student.
Chemical equilibrium is like a business that has too much inventory. The company tries to sell as much product as possible, but eventually they will reach a point where they cannot sell any more product and they will have to start selling products at a loss. At this point, the company is in equilibrium because it has reached a balance between the amount of products it has and the amount of products it can sell.	chemical equilibrium	Explain chemical equilibrium using an analogy. The analogy should be suitable for a business student.
Chemical equilibrium is like a balance in a business. If you have more money coming in than going out, your balance will increase. If you have more money going out than coming in, your balance will decrease. The same is true for chemical equilibrium - if the concentration of reactants is greater than the concentration of products, the reaction will proceed until the concentrations are equal.	chemical equilibrium	Explain chemical equilibrium using an analogy. The analogy should be suitable for a business student.
Chemical equilibrium is like a business that has been in operation for a long time. The company has many products and services, and it has reached a point where it can no longer increase its output. In fact, if the company tried to produce more, it would actually produce less because of the increased amount of waste and wear and tear on the machinery. The same is true for chemical equilibrium; as the concentration of reactants or products increases, the rate of reaction decreases until it reaches a point at which equilibrium is established.	chemical equilibrium	Explain chemical equilibrium using an analogy. The analogy should be suitable for a business student.
Just-in-time is like having a personal assistant who helps you stay organized and on top of your work. The assistant keeps track of what you need to do and when it needs to be done, and makes sure that everything gets done on time.	just-in-time	Explain just-in-time using an analogy. The analogy should be suitable for a business student.
Just-in-time is like having a personal assistant who helps you get what you need when you need it. For example, if you need office supplies, your assistant will get them for you as soon as possible so that you don't have to worry about it.	just-in-time	Explain just-in-time using an analogy. The analogy should be suitable for a business student.
Just-in-time is like having a personal assistant who helps you get everything done just in time for your meeting. She makes sure that all the materials you need are ready and waiting for you when you arrive, and she even takes care of any last-minute emergencies that might come up.	just-in-time	Explain just-in-time using an analogy. The analogy should be suitable for a business student.
Adaptive immunity can be thought of as an organization’s ability to change and improve over time in response to new challenges or opportunities. Just as a business must continually adapt its products, services, and strategies to stay ahead of the competition, so too must the immune system constantly adapt to new threats. This involves not only detecting and eliminating pathogens but also remembering them so that future infections are more likely to be repelled.	adaptive immunity	Explain adaptive immunity using an analogy. The analogy should be suitable for a business student.
Adaptive immunity can be thought of as an organization’s ability to rapidly adapt and respond to changes in its environment. For example, a business might need to quickly adapt its products and services in response to changing consumer needs or preferences. The business might also need to adjust its marketing strategy or operations in order to stay competitive. Similarly, the immune system must constantly adapt and respond to new threats posed by viruses and bacteria.	adaptive immunity	Explain adaptive immunity using an analogy. The analogy should be suitable for a business student.
Adaptive immunity can be thought of as an immune system that "learns" after being exposed to a pathogen. The next time the person is exposed to that pathogen, their adaptive immune system will be better prepared to fight it off, because it has learned from the previous exposure. This analogy might be helpful: Adaptive immunity can be thought of as your company's IT department learning from past security breaches and becoming better equipped to protect your company's data in the future.	adaptive immunity	Explain adaptive immunity using an analogy. The analogy should be suitable for a business student.
The flow of electricity through a wire is like the flow of water through a pipe. Just as the width of the pipe (in inches) affects how much water can flow through it in one minute, so does the thickness of a wire (in gauge) affect how much electricity can flow through it in one minute. The voltage is like the pressure of the water, and just as gallons per minute multiplied by pressure equals total volume (water), volts multiplied by amps equals watts.	ohm's law	Explain ohm's law using an analogy. The analogy should be suitable for a business student.
Ohm's law can be thought of as a flow of water analogy. Just as water flows from high pressure to low pressure, electricity flows from high voltage to low voltage. The higher the voltage (pressure), the more current (flow) will flow. The lower the resistance (restriction), the more current will flow.	ohm's law	Explain ohm's law using an analogy. The analogy should be suitable for a business student.
A simple analogy for Ohm's law is a water hose. The flow of water through the hose (current) is affected by the water pressure (voltage) and the size of the hose opening (resistance).	ohm's law	Explain ohm's law using an analogy. The analogy should be suitable for a business student.
Transcription is like taking meeting minutes. You are listening to what is being said and writing it down verbatim so that everyone has a clear understanding of the discussion.	transcription	Explain transcription using an analogy. The analogy should be suitable for a business student.
Transcription is like taking meeting notes. You are listening to someone speak and writing down what they say as accurately as possible.	transcription	Explain transcription using an analogy. The analogy should be suitable for a business student.
Transcription is like taking meeting notes. You are listening to someone talk and writing down what they say so that you can refer to it later.	transcription	Explain transcription using an analogy. The analogy should be suitable for a business student.
RNA polymerase is like a secretary who takes dictation. The DNA molecule is like a boss who dictates the instructions for making a protein. The RNA polymerase reads the instructions and makes a copy of them in RNA form.	rna polymerase	Explain rna polymerase using an analogy. The analogy should be suitable for a business student.
RNA polymerase is like a secretary. The secretary takes dictation from the boss, and then types it up into a document. In the same way, RNA polymerase takes instructions from DNA (the boss), and creates a new piece of RNA (a document).	rna polymerase	Explain rna polymerase using an analogy. The analogy should be suitable for a business student.
A business analogy for RNA polymerase would be a worker who is hired to produce a product. The worker begins by reading the instructions for making the product, and then starts creating it. As the worker creates the product, they continuously check their work to make sure that it meets the standards specified in the instructions.	rna polymerase	Explain rna polymerase using an analogy. The analogy should be suitable for a business student.
Ribosomes are like machines in a factory. The machines read the instructions on the blueprint and then build the product according to those instructions.	ribosome	Explain ribosome using an analogy. The analogy should be suitable for a business student.
The ribosomes are like the machines in a factory. The DNA is like the blueprint for the machine, and the RNA is like the instructions that tell the machine what to do.	ribosome	Explain ribosome using an analogy. The analogy should be suitable for a business student.
Ribosomes are like the machines that make the products in a factory. The ribosomes read the instructions (the genetic code) and assemble the proteins according to those instructions.	ribosome	Explain ribosome using an analogy. The analogy should be suitable for a business student.
The activator protein is like a key that unlocks the door to the company's vault. The activator protein allows access to the company's assets, which can then be used to generate profits.	activator protein	Explain activator protein using an analogy. The analogy should be suitable for a business student.
The activator protein is like the CEO of a company. It is responsible for making sure that everything runs smoothly and that all of the employees are doing their jobs correctly.	activator protein	Explain activator protein using an analogy. The analogy should be suitable for a business student.
An activator protein is like a key that unlocks the door to a room. The activator protein binds to another molecule called the promoter, which is located near the gene that needs to be activated. When the activator protein and promoter are bound together, they form a complex that can then bind to DNA-binding proteins called transcription factors. This triggers the transcription of the gene into RNA, which ultimately results in the expression of the gene's product.	activator protein	Explain activator protein using an analogy. The analogy should be suitable for a business student.
Electricity is like water in a pipe. The voltage (pressure) is like the water pressure, and the current (flow rate) is like the flow rate of the water. Just as you can have different sizes of pipes, you can have different voltages and currents. You can also have multiple circuits running in parallel, just as you can have multiple pipes carrying water simultaneously.	electric circuit	Explain electric circuit using an analogy. The analogy should be suitable for a business student.
Electricity is like water in a pipe. The voltage (water pressure) is the force that pushes the electricity through the wire. The current (amount of water) is how much electricity flows through the wire at any given time. The resistance (pipe size) is how hard it is for the electricity to flow through the wire.	electric circuit	Explain electric circuit using an analogy. The analogy should be suitable for a business student.
Electricity is like water flowing through a pipe. Voltage is the pressure of the electricity, just like water pressure. Resistance is like the size of the pipe - a small resistance will let more electricity flow than a large resistance. Amperage is how much electricity is flowing at any one time, similar to water flow rate in gallons per minute.	electric circuit	Explain electric circuit using an analogy. The analogy should be suitable for a business student.
Water droplets will stick to each other and form a larger drop. This is because the water molecules are attracted to each other due to their polarity. The hydrogen atoms in the water molecule are positive, while the oxygen atom is negative. Nonpolar substances, such as oil, do not have this same polarity and thus the water droplets will bead up and roll off of an object that is coated in oil. This is known as the hydrophobic effect.	hydrophobic effect	Explain hydrophobic effect using an analogy. The analogy should be suitable for a business student.
The hydrophobic effect can be likened to the way oil and water do not mix. The oil is hydrophobic, meaning it does not like water, while the water is hydrophilic, meaning it likes water. This analogy can be used to explain why some substances (like oils) do not dissolve in other substances (like water).	hydrophobic effect	Explain hydrophobic effect using an analogy. The analogy should be suitable for a business student.
Water molecules are attracted to each other by hydrogen bonds. This attraction creates a cohesive force that gives water its unique properties, such as its ability to flow over surfaces and evaporate easily. However, when water molecules are exposed to certain non-polar substances (hydrophobic materials), the attraction between the water molecules is weaker than the attraction between the water molecules and the hydrophobic material. This causes the water to form droplets around the hydrophobic material, since it is more energetically favorable for the water molecules to be grouped together than it is for them to be scattered randomly among non-polar substances.	hydrophobic effect	Explain hydrophobic effect using an analogy. The analogy should be suitable for a business student.
The process of converting a biological signal into an electrical or chemical signal is similar to how a company converts customer orders into sales. The customer's order (the biological signal) is received by the company, and then it is processed and turned into a sale (an electrical or chemical signal).	biological signal transduction	Explain biological signal transduction using an analogy. The analogy should be suitable for a business student.
Biological signal transduction can be thought of as the process by which a company receives and responds to feedback from its customers. The customer feedback (the biological signal) is transmitted through various channels, such as surveys, focus groups, and social media platforms. The company's management team then evaluates the feedback and decides how to respond (transduce the signal). This might involve making changes to the product or service, developing new marketing campaigns, or implementing new policies.	biological signal transduction	Explain biological signal transduction using an analogy. The analogy should be suitable for a business student.
Biological signal transduction can be thought of as a process similar to the way that email is transmitted. A sender (in this analogy, a molecule or enzyme) creates an email message and attaches it to an outgoing transmission line. The message is then sent through the internet (the cellular membrane in this analogy), where it is received by all of the recipients who have subscribed to that particular address (receptor proteins on the surface of cells).	biological signal transduction	Explain biological signal transduction using an analogy. The analogy should be suitable for a business student.
