Accuracy is the percentage of correct predictions a machine learning algorithm makes. It can be thought of as how often the machine learning algorithm is right.	accuracy	Explain accuracy (machine learning) using an analogy.
The algorithm is like a recipe for a cake. You need to follow the recipe exactly in order to make a cake. If you change the recipe, you might not get a cake at all, or you might get a cake that doesn't taste very good.	algorithm	Explain algorithm (machine learning) using an analogy.
Attribute is a term used in machine learning to describe a property of a data point. Attributes can be numerical or categorical. For example, the attribute "height" would describe the height of a person, while the attribute "color" would describe the color of a person's hair.	attribute	Explain attribute (machine learning) using an analogy.
A bias metric is a way of measuring how much a machine learning algorithm favors one group of data over another. This can be measured by how often the algorithm selects one group of data over another.	bias metric	Explain bias metric (machine learning) using an analogy.
Bias is like a crooked ruler. It can cause your measurements to be inaccurate. In machine learning, bias is when a model is not fair or unbiased. This can happen when the model is trained on a dataset that is not representative of the real world.	bias term	Explain bias term (machine learning) using an analogy.
Categorical variables are like different types of animals. For example, there are different types of cats (Siamese, Persian, etc.), and there are different types of dogs (Poodle, Rottweiler, etc.).	categorical variables	Explain categorical variables (machine learning) using an analogy.
Classification is like a teacher separating students into different classes based on their ability. The teacher is using past data (the students' test scores) to make a prediction about which class a new student should be placed in.	classification	Explain classification (machine learning) using an analogy.
Classification threshold is the point at which a machine learning algorithm decides whether a new observation belongs to a pre-determined category or not. In other words, it is the point at which a machine learning algorithm decides whether a new observation is similar enough to an existing observation to be classified in the same category.	classification threshold	Explain classification threshold (machine learning) using an analogy.
Clustering is like sorting a deck of cards. You can sort the cards by color, by suit, or by number. You can also put the cards in any order you want. Clustering is like sorting the cards by color. You put all of the red cards together, all of the blue cards together, and all of the green cards together.	clustering	Explain clustering (machine learning) using an analogy.
A confusion matrix is a table that is used to help understand how a machine learning algorithm is performing. The table shows how many times each class was predicted by the machine learning algorithm, and how many times each class was actually found in the data.	confusion matrix	Explain confusion matrix (machine learning) using an analogy.
Continuous variables are like the temperature in a room. The temperature can be any number between 0 and 100 degrees Celsius.	continuous variables	Explain continuous variables (machine learning) using an analogy.
Convergence is a process of machine learning in which a computer system becomes better at performing a task the more it is used. This is similar to how humans learn; the more we practice a skill, the better we become at it.	convergence	Explain convergence (machine learning) using an analogy.
Deduction is like a detective coming to a crime scene and figuring out who did it. The detective looks at the clues and uses reason to come to a conclusion.	deduction	Explain deduction (machine learning) using an analogy.
Deep learning is like a human brain. It is a way of teaching a computer to learn from data, without being explicitly programmed.	deep learning	Explain deep learning (machine learning) using an analogy.
Dimension is a bit like a map. It is a way of organizing information so that it is easy to understand and work with. In machine learning, the dimensions might be the features of a data set.	dimension	Explain dimension (machine learning) using an analogy.
Epoch is a time period in which a machine learning algorithm is trained on a set of data. Think of it as a school year. The data is the students, and the algorithm is the teacher. The algorithm "learns" by adjusting its parameters based on how well it performs on the data. At the end of the school year, the algorithm has "learned" from the students and is ready to start teaching the next year's class.	epoch	Explain epoch (machine learning) using an analogy.
Extrapolation is like using a map to figure out what lies ahead on your journey. The map is a representation of the world, and by looking at it, you can get an idea of what to expect in the future. Similarly, in machine learning, extrapolation is the process of using past data to predict future events.	extrapolation	Explain extrapolation (machine learning) using an analogy.
False positive rate is the rate at which a machine learning algorithm incorrectly classifies a data point as belonging to a particular category, when it actually does not. This rate is usually expressed as a percentage.False positive rate can be thought of as the percentage of times a security alarm goes off when there is no actual intruder.	false positive rate	Explain false positive rate (machine learning) using an analogy.
Feature (machine learning) is like a person's height. It is a characteristic that is used to describe that person.	feature	Explain feature (machine learning) using an analogy.
Feature selection is like a person choosing what clothes to wear. The person has many different clothes to choose from, but they can only wear a certain number of clothes at a time. So, the person has to choose which clothes to wear based on what they want to wear and what looks good together.	feature selection	Explain feature selection (machine learning) using an analogy.
Feature vector is like a shopping list for a grocery store. It is a list of all the items that you need to buy. The feature vector stores the information about each item in the list, such as the item's name and the quantity you need.	feature vector	Explain feature vector (machine learning) using an analogy.
Gradient accumulation is a machine learning technique that helps a computer system learn how to recognize patterns in data. It works by gradually adding up the "gradient" of the error function. This helps the system to focus on the most important aspects of the data, and to learn how to recognize patterns more accurately.	gradient accumulation	Explain gradient accumulation (machine learning) using an analogy.
Hyperparameters are like the knobs and dials on a machine that you can tweak to change how it works. In machine learning, you can think of hyperparameters as the settings you can change to affect the performance of a model.	hyperparameters	Explain hyperparameters (machine learning) using an analogy.
Induction is like a teacher. The teacher sees one student do something once, and then the teacher can predict that all other students will do the same thing.	induction	Explain induction (machine learning) using an analogy.
Instance is like a student in a classroom. The student is an example of an instance.	instance	Explain instance (machine learning) using an analogy.
Labeling is like putting a name tag on someone. It is a way of identifying someone or something. In machine learning, labeling is the process of identifying the features of a data set.	label	Explain label (machine learning) using an analogy.
The learning rate is the speed at which a machine learning algorithm learns. It is analogous to the speed at which a human learns.	learning rate	Explain learning rate (machine learning) using an analogy.
Loss is the opposite of gain. In the context of machine learning, it is the reduction in the accuracy of a machine learning algorithm as it is exposed to more data.	loss	Explain loss (machine learning) using an analogy.
Machine learning is like a child learning to speak. At first, the child hears individual words and phrases and tries to imitate them. With time and practice, the child begins to understand the meaning of words and how they fit together to form sentences. Machine learning works in a similar way. It starts by learning how to recognize patterns in data. With time and practice, it begins to understand the meaning of those patterns and how they fit together to form models.	machine learning	Explain machine learning (machine learning) using an analogy.
A model is like a recipe. It is a set of instructions that tells you how to make something. A machine learning model is a set of instructions that tells a computer how to learn.	model	Explain model (machine learning) using an analogy.
Neural networks are a bit like the human brain. They can learn how to do things by example, and then remember how to do them even if they are not explicitly told what to do.	neural networks	Explain neural networks (machine learning) using an analogy.
Normalization is a technique used in machine learning to reduce the impact of bias in data. It is similar to the technique of averaging used in statistics. In normalization, the values in a data set are scaled so that they all have the same range. This makes it easier to compare different data sets and to find patterns in the data.	normalization	Explain normalization (machine learning) using an analogy.
Noise is like static on a TV screen. It's something that can interfere with the clarity of the image. In machine learning, noise is any kind of interference that can distort the accuracy of the data.	noise	Explain noise (machine learning) using an analogy.
Null accuracy is the percentage of data points in a dataset that a machine learning algorithm is not able to predict. This can be thought of as the percentage of data points that the algorithm is "blind" to. It can be helpful to think of null accuracy as the percentage of data points that the algorithm is not able to see, just as humans are not able to see in the dark.	null accuracy	Explain null accuracy (machine learning) using an analogy.
Observation in machine learning is similar to looking at a picture. You can see different features in the picture, and you can learn more about the picture by studying it closely. In the same way, machine learning algorithms can learn more about data by studying it closely.	observation	Explain observation (machine learning) using an analogy.
An outlier is a data point that is significantly different from the other data points in a dataset. Outliers can be caused by errors in data collection or by natural variation in the data. They can be removed from a dataset before analysis, or they can be used to identify unusual patterns in the data.	outlier	Explain outlier (machine learning) using an analogy.
Overfitting is like when you learn a new song on the guitar, and you can play it perfectly, but you can only play it in one specific key. If someone asks you to play the song in a different key, you won't be able to do it as well because you've only practiced it in one specific key.	overfitting	Explain overfitting (machine learning) using an analogy.
Parameters in machine learning are like the knobs and levers on a machine. They allow you to control how the machine works. In the same way, parameters in machine learning allow you to control how the machine learning algorithm works.	parameters	Explain parameters (machine learning) using an analogy.
Precision is the number of true positives divided by the number of true positives and false negatives. It is a measure of how well a classifier performs on the positive examples it is given.	precision	Explain precision (machine learning) using an analogy.
Recall is like when you are looking for something you know you have but can't remember where you put it. You keep looking around your house until you find it. With recall, the machine is looking through all of the data it has been given until it finds the answer it is looking for.	recall	Explain recall (machine learning) using an analogy.
Recall is like a Google search. You put in a few keywords and Google tries to give you the best results. Precision is like a Google search with the "I'm Feeling Lucky" button. Instead of giving you a list of results, it takes you directly to the first result.	recall vs precision	Explain recall vs precision (machine learning) using an analogy.
Regression is like a teacher. The teacher is always there to help you learn and make sure you understand the material. The teacher will give you feedback on your work and help you correct your mistakes.	regression	Explain regression (machine learning) using an analogy.
Regularization is a technique used in machine learning to prevent overfitting. It can be thought of as a way of adding "fuzziness" to a model, so that it is less likely to perfectly match the training data and is more likely to generalize to new data. This can be done by adding a penalty to the cost function of the model, which makes it more difficult to fit the data perfectly.	regularization	Explain regularization (machine learning) using an analogy.
Reinforcement learning is like teaching a dog how to fetch a ball. Initially, you would have to show the dog how to do it, but eventually, the dog will learn how to do it on its own.	reinforcement learning	Explain reinforcement learning (machine learning) using an analogy.
A roc curve is a graph that shows the true positive rate (TPR) and false positive rate (FPR) as a function of the false positive rate. The TPR is the percentage of predictions that are correct, while the FPR is the percentage of predictions that are incorrect. The roc curve is used to evaluate the performance of a classifier.	roc curve	Explain roc curve (machine learning) using an analogy.
Segmentation is like sorting a deck of cards. The cards are first divided into two piles, then each pile is divided into two more piles, and so on. At the end, there are 52 piles, one for each card in the deck.	segmentation	Explain segmentation (machine learning) using an analogy.
If you want to learn to play the guitar, you could take a class at a music school, or you could buy a guitar and teach yourself. The class will be more specific in teaching you how to play the guitar, but it will also be more expensive. If you buy a guitar and teach yourself, you will be less specific in what you learn, but it will be cheaper.	specificity	Explain specificity (machine learning) using an analogy.
Supervised learning is like a teacher giving a student a worksheet with problems to solve. The teacher is there to help the student if they get stuck, but the student is ultimately responsible for solving the problems. In the same way, a machine learning algorithm is given a set of training data (the worksheet) and is responsible for learning how to solve the problems (the problems on the worksheet). The algorithm is helped by a human supervisor who corrects any mistakes the algorithm makes and provides feedback so that the algorithm can learn from its mistakes.	supervised learning	Explain supervised learning (machine learning) using an analogy.
A test set is like a practice set when you are learning how to play a new sport. The practice set helps you learn the rules of the game and how to play it. The test set helps you see how well you have learned the game by giving you a challenge.	test set	Explain test set (machine learning) using an analogy.
A training set is like a set of flashcards. The training set is used to teach the machine learning algorithm how to predict the correct answer for a given input.	training set	Explain training set (machine learning) using an analogy.
Transfer learning is like teaching a second language. The first time you learn a new language, it is difficult because you have to learn all the new words and grammar rules. But if you already know a language, it is easier to learn a new language because you can use the knowledge you already have. Machine learning algorithms can use knowledge from a previous task to help them learn a new task more quickly.	transfer learning	Explain transfer learning (machine learning) using an analogy.
The true positive rate is the percentage of positive examples that a machine learning algorithm correctly identifies as being positive. This is analogous to a human correctly identifying a positive example from a set of pictures.	true positive rate	Explain true positive rate (machine learning) using an analogy.
Type 1 error is like when you think your phone is ringing, but it's just your alarm clock.	type 1 error	Explain type 1 error (machine learning) using an analogy.
Type 2 error is like when you are playing a game of poker and you think you have a good hand, but you actually have a bad hand. You end up losing the game even though you had a good hand to start with.	type 2 error	Explain type 2 error (machine learning) using an analogy.
Underfitting is like trying to fit a square peg in a round hole. The machine learning algorithm is not able to find the correct pattern in the data and therefore is not able to make accurate predictions.	underfitting	Explain underfitting (machine learning) using an analogy.
The universal approximation theorem states that a machine learning algorithm can approximate any function to any desired degree of accuracy. This is analogous to the way that a pencil can be used to draw a line that is close to any desired shape.	universal approximation theorem	Explain universal approximation theorem (machine learning) using an analogy.
Unsupervised learning is like being a detective. You are given some information (data) but not told who the criminal is or what the crime is. You have to use your detective skills to try to figure out what the crime is and who committed it.	unsupervised learning	Explain unsupervised learning (machine learning) using an analogy.
A validation set is like a group of people who work for a company and are used to test how well the company's new policies are working. The validation set is used to make sure that the company's new policies are actually working and not just making things worse.	validation set	Explain validation set (machine learning) using an analogy.
Variance is a measure of how spread out a set of data points is. It is calculated by taking the average of the squared differences between each data point and the mean of the data set. This measure is used to determine how much variation there is in a data set and can help to identify outliers.	variance	Explain variance (machine learning) using an analogy.
A/B testing is like a scientist testing two different theories about how the world works. The scientist does an experiment to see which theory is correct. In the same way, A/B testing tests two different versions of a website or app to see which one is more effective.	a/b testing	Explain a/b testing (machine learning) using an analogy.
Action (machine learning) can be thought of as a person learning how to play a new video game. The person starts by playing the game very slowly, and only making simple moves. As they continue to play, they learn new moves and strategies that allow them to play the game faster and better.	action	Explain action (machine learning) using an analogy.
The activation function is like a bouncer at a nightclub. It decides which people are allowed into the club and which people are not. The activation function in machine learning decides which data is allowed to pass through to the next layer in the neural network and which data is not.	activation function	Explain activation function (machine learning) using an analogy.
Active learning is like a person who is learning a new language. The person is not just sitting in a classroom and listening to a teacher talk. The person is also out in the world speaking with people who are native speakers of the language. The person is constantly practicing and learning.	active learning	Explain active learning (machine learning) using an analogy.
Adagrad is a machine learning algorithm that adjusts the learning rate for each parameter in real time, based on the history of the gradient descent steps. It is similar to momentum, but it uses the history of the gradient descent steps to determine the learning rate for each parameter.	adagrad	Explain adagrad (machine learning) using an analogy.
An agent is like a personal assistant. It can be trained to do specific tasks, such as scheduling appointments or ordering groceries. The agent can learn from experience, so it can get better at completing tasks over time.	agent	Explain agent (machine learning) using an analogy.
Agglomerative clustering is a machine learning technique that is used to group data points together. The technique works by starting with all of the data points being grouped together. Then, the data points are divided into two groups based on the closest distance between two data points. The process is then repeated until all of the data points are grouped into a single group.	agglomerative clustering	Explain agglomerative clustering (machine learning) using an analogy.
Anomaly detection is like a security guard at a door. The security guard is looking for people who are not supposed to be at the door. Anomaly detection is looking for things that are not supposed to happen.	anomaly detection	Explain anomaly detection (machine learning) using an analogy.
Ar is like a computer that is constantly learning. It is constantly taking in new information and trying to find patterns. It then uses these patterns to make predictions about future events.	ar	Explain ar (machine learning) using an analogy.
The area under the pr curve is like a fitness function. The higher the value of the function, the better the fitness of the model. The area under the curve is also like a cost function. The lower the value of the function, the lower the cost of the model.	area under the pr curve	Explain area under the pr curve (machine learning) using an analogy.
The area under the roc curve is a measure of how well a machine learning algorithm can distinguish between two classes of objects. It can be thought of as a measure of how well the algorithm can predict the class of an object given its features.	area under the roc curve	Explain area under the roc curve (machine learning) using an analogy.
One way to think about artificial general intelligence is as a computer program that can learn how to do anything a human can do. For example, you could show it a picture of a cat and tell it that a cat is a furry animal with a long tail. Then, the next time you show it a picture of a dog, the computer program would be able to say that a dog is a furry animal with a long tail.	artificial general intelligence	Explain artificial general intelligence (machine learning) using an analogy.
One way to think about artificial intelligence is as a “black box” that takes in data and churns out predictions or decisions. This black box is powered by algorithms that are “trained” on data. The idea behind machine learning is that you can give these algorithms more and more data, and they will get better and better at making predictions or decisions.	artificial intelligence	Explain artificial intelligence (machine learning) using an analogy.
Attention is a bit like a spotlight. It is a way of focusing on a particular part of the data so that you can learn from it more effectively.	attention	Explain attention (machine learning) using an analogy.
AUC is the area under the ROC curve. It is a measure of how well a classifier can distinguish between positive and negative examples. The higher the AUC, the better the classifier.	auc (area under the roc curve)	Explain auc (area under the roc curve) (machine learning) using an analogy.
Augmented reality is like a teacher that is always there to help you learn. The teacher is always there to help you with anything you don't understand and is always available to answer any questions you have.	augmented reality	Explain augmented reality (machine learning) using an analogy.
When a person is learning to drive a car, they are constantly adjusting their steering wheel and pedals to keep the car going in the right direction. Over time, the person learns how to keep the car going without having to think about it, and they can focus on other things. This is similar to how a machine learning algorithm can be taught to recognize patterns in data, without having to be explicitly programmed to do so.	automation bias	Explain automation bias (machine learning) using an analogy.
The average precision of a machine learning algorithm is the average of the precision scores of all the predictions it makes. It is a measure of how accurate the algorithm is at predicting the correct class for a given instance.	average precision	Explain average precision (machine learning) using an analogy.
Backpropagation is a bit like teaching a child to read. First, you give them a basic understanding of the alphabet and how to put letters together to form words. Then, you give them examples of words and how they are pronounced. Finally, you have them read a book. Backpropagation works in a similar way. First, you give the computer a basic understanding of how to do something (like recognize objects in a photo). Then, you give it examples of how to do it. Finally, you have it do something on its own.	backpropagation	Explain backpropagation (machine learning) using an analogy.
A bag of words is a data structure that stores a collection of words, along with a count of how often each word appears in a given text. Bag of words models are used in machine learning to predict the probability of a given word appearing in a text, based on the frequencies of other words in the text.	bag of words	Explain bag of words (machine learning) using an analogy.
Baseline is like the foundation of a house. It is the starting point and is essential for the stability of the house. In machine learning, the baseline is a set of data that is used to train the machine learning algorithm.	baseline	Explain baseline (machine learning) using an analogy.
Batch learning is a machine learning technique where a set of training data is divided into a number of batches, and each batch is used to train a model. The models are then evaluated on a separate set of data (the validation set), and the best model is selected.	batch	Explain batch (machine learning) using an analogy.
Batch normalization is a technique used in machine learning to reduce the variance of a set of training data. This is done by adjusting the values of the data so that they are more consistent and therefore easier to learn from. This is done by adjusting the values of the data so that they are more consistent and therefore easier to learn from.An analogy for batch normalization would be to think of a group of students who are all different heights. In order to make it easier for a teacher to teach them, they would all need to be adjusted to be the same height. This would be done by batch normalization.	batch normalization	Explain batch normalization (machine learning) using an analogy.
Batch size is the number of data points that are used to train a machine learning algorithm at one time. It is analogous to the number of students that are assigned to one teacher in a classroom.	batch size	Explain batch size (machine learning) using an analogy.
A bayesian neural network is a bit like a group of people who have never met before, but who are all trying to learn about a particular topic. Each person in the group is given some information about the topic, and then they all share what they've learned with each other. This process continues until everyone in the group has a good understanding of the topic.	bayesian neural network	Explain bayesian neural network (machine learning) using an analogy.
Bayesian optimization is like a treasure hunt. The treasure is the best possible solution to a problem. The map is the algorithm that you are using to find the treasure. The clues are the data that you are using to find the treasure. The treasure hunter is the machine learning algorithm.	bayesian optimization	Explain bayesian optimization (machine learning) using an analogy.
The bellman equation is a mathematical formula used in machine learning that calculates the value of a function at a given point in time. The equation can be used to determine the best course of action for a machine learning algorithm, given the current state of the system and the desired outcome.An analogy for the bellman equation might be a driver trying to get to a destination. The driver knows the current location, the desired destination, and the current state of the car (speed, direction, etc.). The bellman equation can help the driver determine the best way to get to the destination, based on the current state of the car and the desired outcome.	bellman equation	Explain bellman equation (machine learning) using an analogy.
Bert is a machine learning algorithm that is used to improve the accuracy of predictions made by a machine learning model. Bert works by taking a large number of text documents and breaking them down into a series of smaller pieces, or tokens. It then uses a machine learning model to learn the relationships between these tokens and the words they represent. This information can then be used to improve the accuracy of predictions made by a machine learning model.	bert (bidirectional encoder representations from transformers)	Explain bert (bidirectional encoder representations from transformers) (machine learning) using an analogy.
Bias in machine learning is similar to bias in humans. It is the tendency to favor one thing over another, often without realizing it. In machine learning, this can mean that a machine is more likely to learn from data that is skewed in some way. This can lead to inaccurate results and unfairness in decision-making.	bias (ethics/fairness)	Explain bias (ethics/fairness) (machine learning) using an analogy.
Bias is like a crooked ruler. It can cause inaccurate measurements. In machine learning, bias can cause inaccurate predictions.	bias (math)	Explain bias (math) (machine learning) using an analogy.
A bigram is a machine learning algorithm that uses two adjacent words in a text document to predict the likelihood of the next word in the document. This algorithm is used to improve the accuracy of predictions by taking into account the context of the words in the document.	bigram	Explain bigram (machine learning) using an analogy.
Bidirectional machine learning is like a two-way street. It's a type of machine learning where the system can learn from both its past experiences and the experiences of other systems it is interacting with. This helps the system become more accurate and efficient in its predictions.	bidirectional	Explain bidirectional (machine learning) using an analogy.
A bidirectional language model is a machine learning model that can be used to predict the next word in a text given the previous words. It can also be used to predict the previous word in a text given the next words.	bidirectional language model	Explain bidirectional language model (machine learning) using an analogy.
Binary classification is like sorting a group of people into two categories: men and women.	binary classification	Explain binary classification (machine learning) using an analogy.
Binning is a technique used in machine learning to reduce the number of dimensions in a feature vector. It is analogous to the process of sorting objects into bins or groups. For example, you might sort a group of objects by their color, and then put all the red objects into one bin, all the blue objects into another bin, and so on.	binning	Explain binning (machine learning) using an analogy.
Bleu is a measure of how close a text is to a translation of a text in a second language. It is used in machine learning to measure the quality of a translation.	bleu (bilingual evaluation understudy)	Explain bleu (bilingual evaluation understudy) (machine learning) using an analogy.
Boosting is a machine learning technique that is used to improve the accuracy of a classifier. It does this by taking a set of classifiers and combining them into a single classifier. The individual classifiers are then trained on a subset of the data, and the combined classifier is trained on the full data set.	boosting	Explain boosting (machine learning) using an analogy.
A bounding box is like a frame around a picture. It is used to help identify and describe what is in the picture. In machine learning, a bounding box is used to help identify and describe what is in a picture (or a set of pictures).	bounding box	Explain bounding box (machine learning) using an analogy.
Broadcasting is a technique used in machine learning for reducing the number of parameters in a model. It works by creating a copy of the model with a reduced number of parameters and then transferring the prediction from the original model to the reduced model. This is done by multiplying the input vector by a weight matrix and then adding a bias vector.	broadcasting	Explain broadcasting (machine learning) using an analogy.
Bucketing is a technique used in machine learning for reducing the size of a data set. The data set is divided into a number of buckets, or groups, so that similar data is grouped together. This makes it easier to find patterns and to train a machine learning algorithm.	bucketing	Explain bucketing (machine learning) using an analogy.
A calibration layer is like a map. It helps a machine learning algorithm understand the relationship between different inputs and outputs. This allows the algorithm to predict the output for a new input it has never seen before.	calibration layer	Explain calibration layer (machine learning) using an analogy.
Candidate generation is like finding a needle in a haystack. The computer is given a large number of potential solutions (haystacks) and it is tasked with finding the best one. The computer does this by trying a large number of potential solutions (candidates) and then narrowing it down to the best one.	candidate generation	Explain candidate generation (machine learning) using an analogy.
Sampling is like taking a small sip from a large container of water. This gives you a taste of what the water is like without having to drink the entire container. Sampling is a way to reduce the amount of data you need to analyze in order to make a decision.	candidate sampling	Explain candidate sampling (machine learning) using an analogy.
Categorical data is like a deck of cards. The cards are divided into different suits (clubs, hearts, spades, diamonds) and different ranks (Ace, 2, 3, 4, etc). Just like you can draw different cards from a deck, you can get different values for categorical data.	categorical data	Explain categorical data (machine learning) using an analogy.
A causal language model is a machine learning algorithm that is used to predict the next word in a text sequence. The algorithm is trained on a set of text data that includes a sequence of words and the corresponding probabilities of each word appearing next to the other words in the sequence. The algorithm can then be used to predict the next word in a text sequence based on the probabilities of the words in the sequence.	causal language model	Explain causal language model (machine learning) using an analogy.
A centroid is the average of all the points in a set. It's like the center of a target.	centroid	Explain centroid (machine learning) using an analogy.
Centroid-based clustering is similar to finding the center of a group of people. The algorithm finds the center of mass or the centroid of a group of data points and then creates clusters around that centroid.	centroid-based clustering	Explain centroid-based clustering (machine learning) using an analogy.
A good analogy for co-adaptation is learning to ride a bike. When you first learn to ride a bike, you have to think about how to balance yourself, how to pedal, and how to steer. But after you've ridden a bike a few times, you don't have to think about any of those things anymore - you just do them automatically. That's because your brain has co-adapted to the bike. It's learned how to balance itself, pedal, and steer, and now it can do all of those things without you having to think about them.	co-adaptation	Explain co-adaptation (machine learning) using an analogy.
Collaborative filtering is a technique used by online services such as Amazon and Netflix to recommend products or movies to users. It relies on the assumption that if someone liked a particular product or movie, they are likely to like similar products or movies. The technique uses the data from past customers to create a model that can predict what a customer might like.	collaborative filtering	Explain collaborative filtering (machine learning) using an analogy.
Confirmation bias is like a person who is looking for a specific item at a store. The person is only going to look in the areas where they think the item is most likely to be. This is similar to how a machine learning algorithm is going to look for patterns in data. The algorithm is going to look in the areas where it thinks the patterns are most likely to be.	confirmation bias	Explain confirmation bias (machine learning) using an analogy.
Continuous feature is a bit like volume on a stereo. You can turn it up and down to change the sound. With machine learning, you can change the features (or volume) to change the outcome.	continuous feature	Explain continuous feature (machine learning) using an analogy.
Convenience sampling is like when you go to the grocery store and you only pick the items that are easy to get to. You don't have to go up and down the aisles to find them.	convenience sampling	Explain convenience sampling (machine learning) using an analogy.
A convex function is like a ramp. It is easy to go up and down, but it is hard to go sideways.	convex function	Explain convex function (machine learning) using an analogy.
Convex optimization is a bit like trying to fit a round peg into a square hole. You have a lot of different ways to try to fit the peg in, and you can keep trying until you find the best way. But if the hole is too small, you can't fit the peg in no matter what you do.	convex optimization	Explain convex optimization (machine learning) using an analogy.
A convex set is like a rubber band. It is easy to deform it by stretching it, but it is hard to fold it in half.	convex set	Explain convex set (machine learning) using an analogy.
Convolution is a bit like a recipe. You have a list of ingredients, and a set of instructions on how to mix them together. Convolutional neural networks are like recipes for machines. They contain a list of ingredients (the features of the input data), and a set of instructions on how to mix them together (the weights of the network).	convolution	Explain convolution (machine learning) using an analogy.
Convolutional filters are like a set of filters that a person might use when cleaning their house. The filters might be a vacuum cleaner to suck up dirt, a broom to sweep the dirt into a pile, and a dustpan to collect the dirt. The filters work together to clean the house.	convolutional filter	Explain convolutional filter (machine learning) using an analogy.
A convolutional layer is like a set of filters that a photographer might use to change the look of an image. The filters might change the brightness, the color, or the contrast of the image.	convolutional layer	Explain convolutional layer (machine learning) using an analogy.
A convolutional neural network is a bit like a very sophisticated set of filters that can be applied to an image. The filters can learn to recognize patterns in the image, and then they can be used to change the image in different ways.	convolutional neural network	Explain convolutional neural network (machine learning) using an analogy.
Convolutional operation is like a filter that is applied to an image. The filter can be used to blur or sharpen the image.	convolutional operation	Explain convolutional operation (machine learning) using an analogy.
The cost of a machine learning algorithm can be thought of as the price of admission. It is the price you pay to use the algorithm to make predictions. The cost is usually measured in terms of the number of predictions you need to make in order to get a good estimate of the algorithm's accuracy.	cost	Explain cost (machine learning) using an analogy.
Co-training is a machine learning technique that uses two or more different learning algorithms to jointly learn a task. The different algorithms work together to share information and improve the overall accuracy of the system. This technique is often used when the task is too difficult for a single algorithm to learn on its own.	co-training	Explain co-training (machine learning) using an analogy.
Counterfactual fairness is a machine learning technique that helps to ensure that artificial intelligence systems treat all individuals fairly, even in cases where the data used to train the system is biased. It does this by creating "what-if" scenarios in which the data is manipulated to create a more equal playing field. This allows the system to be tested for bias and ensures that it produces equitable results.	counterfactual fairness	Explain counterfactual fairness (machine learning) using an analogy.
One way to think about coverage bias is to imagine that you are a judge in a criminal trial. The prosecutor has evidence that the defendant committed the crime, but the defense attorney argues that there is a reasonable doubt that the defendant is guilty. The prosecutor has more evidence than the defense attorney, but the defense attorney has some evidence. The prosecutor is more likely to win the case, but the defense attorney still has a chance of winning.In the context of machine learning, coverage bias is the tendency for models to be more likely to predict the correct answer for a training set that is larger and more diverse. This is because models that are more likely to predict the correct answer will be more likely to be selected for larger and more diverse training sets.	coverage bias	Explain coverage bias (machine learning) using an analogy.
Crash Blossom is a term used in machine learning to describe a situation where a machine learning algorithm is overfitting the training data, and as a result, is not able to generalize to new data. This can often lead to the algorithm crashing when it is used to predict outcomes for new data.An analogy for this would be a student who only studies for exams by memorizing the questions and answers. This student is likely to do well on the exams that they have studied for, but will likely not do well on exams that are different from the ones they have studied for.	crash blossom	Explain crash blossom (machine learning) using an analogy.
A critic in machine learning is a program that evaluates the performance of other programs. It is similar to a teacher who evaluates the work of students and provides feedback to help them improve.	critic	Explain critic (machine learning) using an analogy.
Cross-entropy is a measure of how different two probability distributions are. It is often used in machine learning to find the best possible distribution to fit a set of data.Cross-entropy can be thought of as the distance between two probability distributions. The smaller the distance, the more similar the two distributions are.	cross-entropy	Explain cross-entropy (machine learning) using an analogy.
Cross-validation is a technique used in machine learning to estimate the accuracy of a model. It works by splitting the data into two parts: the training set and the validation set. The training set is used to train the model, and the validation set is used to evaluate the accuracy of the model. This process is repeated multiple times, and the average accuracy of the model is calculated.	cross-validation	Explain cross-validation (machine learning) using an analogy.
Data analysis is like a detective investigating a crime. The detective gathers evidence (data) and uses it to figure out what happened (analysis). Then they use that information to solve the crime (machine learning).	data analysis	Explain data analysis (machine learning) using an analogy.
Data augmentation is a technique used in machine learning to improve the performance of a model by increasing the size of the training dataset. This is done by artificially adding new data to the dataset, which is generated by transforming or augmenting the original data. This can be done by adding new features to the data, or by perturbing the values of existing features.	data augmentation	Explain data augmentation (machine learning) using an analogy.
A decision boundary is like a fence. It is a line that separates two areas. In machine learning, it is used to separate the data that is being used to train the machine learning algorithm from the data that is not being used to train the machine learning algorithm.	decision boundary	Explain decision boundary (machine learning) using an analogy.
A decision threshold is a point at which a machine learning algorithm decides whether or not to classify an input as belonging to a certain category. For example, a machine learning algorithm might be trained to distinguish between images of cats and images of dogs. If the decision threshold is set too high, the machine learning algorithm may not be able to correctly classify any images. If the decision threshold is set too low, the machine learning algorithm may incorrectly classify images.	decision threshold	Explain decision threshold (machine learning) using an analogy.
A decision tree is like a flowchart that helps you make a decision. It starts with a question, and then leads you to a decision based on your answer.	decision tree	Explain decision tree (machine learning) using an analogy.
Deep learning is a bit like the brain. The brain has many layers of neurons, and each layer is connected to the next. The first layer receives input from the senses, such as sight and sound. The next layer processes that information and sends it to the next layer, which might analyze it and send it to the next layer, and so on. The final layer sends output to the muscles, telling them what to do.In deep learning, each layer is a computer network that is trained to recognize patterns in data. The first layer might learn to recognize patterns in images, the next layer might learn to recognize patterns in the images that the first layer recognized, and so on. The final layer might learn to recognize patterns in text or in other types of data.	deep model	Explain deep model (machine learning) using an analogy.
A decoder is like a teacher. The teacher helps students learn and understand new material. The teacher also helps students review and practice old material.	decoder	Explain decoder (machine learning) using an analogy.
A deep neural network is a bit like the human brain. It is made up of a large number of interconnected processing nodes, or neurons, that can learn to recognize patterns of input data. Just as the brain can learn to recognize patterns of sounds, images, and other sensory information, a deep neural network can learn to recognize patterns in data.	deep neural network	Explain deep neural network (machine learning) using an analogy.
A deep q-network is a machine learning algorithm that is used to learn how to play games. It is similar to a deep neural network, but it is specifically designed to learn how to play games.	deep q-network (dqn)	Explain deep q-network (dqn) (machine learning) using an analogy.
Demographic parity is a term used in machine learning that describes a situation where the distribution of training data is balanced across different categories. This means that there is an equal number of observations in each category, which helps to ensure that the machine learning algorithm is not biased towards any particular group. An analogy for this would be a classroom where the number of students in each grade is evenly distributed. This would help to ensure that the teacher is not biased towards any particular group of students.	demographic parity	Explain demographic parity (machine learning) using an analogy.
Denoising is a machine learning technique used to remove noise from a signal. It is similar to a noise filter in that it cleans up the signal and makes it easier to understand. Denoising is often used in image processing and speech recognition.	denoising	Explain denoising (machine learning) using an analogy.
Dense features are like a group of people who are all standing close together. They are easy to see and easy to identify.	dense feature	Explain dense feature (machine learning) using an analogy.
A dense layer is a layer in a machine learning algorithm in which most of the neurons are connected to most of the other neurons.	dense layer	Explain dense layer (machine learning) using an analogy.
Depth in machine learning is similar to depth in photography. Just as a photograph has a depth of field that determines what is in focus, a machine learning algorithm has a depth of field that determines what it is able to learn. The depth of field can be increased by increasing the number of layers in the machine learning algorithm.	depth	Explain depth (machine learning) using an analogy.
Depthwise separable convolutional neural networks are a type of neural network that are composed of two separate convolutional neural networks: a depthwise network and a separable network. The depthwise network is responsible for extracting features from the input data, while the separable network is responsible for classifying the input data.	depthwise separable convolutional neural network (sepcnn)	Explain depthwise separable convolutional neural network (sepcnn) (machine learning) using an analogy.
Dimension reduction is like squeezing a huge block of Jell-O into a small mold. You lose a lot of the original volume, but the shape is still there. The same is true for data. You can reduce the number of dimensions, or features, without losing too much information about the data.	dimension reduction	Explain dimension reduction (machine learning) using an analogy.
Dimensions are like the different colors of paint that a painter has to work with. In the same way, a machine learning algorithm has a range of different "colors" to choose from in order to best solve a problem.	dimensions	Explain dimensions (machine learning) using an analogy.
A discrete feature is like a light switch. It can be either on or off, and it can only be in one state at a time.	discrete feature	Explain discrete feature (machine learning) using an analogy.
A discriminative model is like a map. It takes in input data (like coordinates) and outputs a prediction (like a location on the map). The map is designed to be accurate for a specific purpose (like finding a specific address).	discriminative model	Explain discriminative model (machine learning) using an analogy.
A discriminator is a bit like a bouncer at a nightclub. It is responsible for deciding who is allowed into the club (i.e. who is a valid member of the club) and who is not. In machine learning, the discriminator is responsible for deciding whether a given input is a member of the training dataset or not.	discriminator	Explain discriminator (machine learning) using an analogy.
Disparate impact is a term used in machine learning to describe a situation where a machine learning algorithm produces a result that unfairly discriminates against a particular group of people. This can happen, for example, if an algorithm is trained on data that is biased against a particular group of people.	disparate impact	Explain disparate impact (machine learning) using an analogy.
Disparate treatment is like when a teacher singles out one student in a classroom and gives them more attention than the others. This might be because the teacher likes that student more, or thinks they are smarter, or because the teacher thinks they need more help.	disparate treatment	Explain disparate treatment (machine learning) using an analogy.
One way to think of divisive clustering is to imagine that you are a judge at a beauty pageant. You have a group of 10 contestants, and you need to divide them into two groups. You could put all of the beautiful contestants in one group, and all of the ugly contestants in the other group, but that would not be a very fair division. A better way to divide the contestants would be to put the most beautiful contestants in one group, and the less beautiful contestants in the other group. This is the idea behind divisive clustering.	divisive clustering	Explain divisive clustering (machine learning) using an analogy.
Downsampling is like when you are watching a movie on your phone and the image quality is not as good as when you are watching it on your TV. The image on your phone has been downsampled from the original image.	downsampling	Explain downsampling (machine learning) using an analogy.
A computer is like a brain. It can learn how to do things by being taught, and it can remember what it has learned.	dqn	Explain dqn (machine learning) using an analogy.
In early stopping, the learning algorithm is stopped as soon as it has found a solution that is close enough to the global optimum. This is analogous to stopping a racecar driver as soon as he has passed the finish line.	early stopping	Explain early stopping (machine learning) using an analogy.
The earth mover's distance is a measure of how different two probability distributions are. It is similar to the Euclidean distance, but takes into account the fact that some points are more important than others. The distance is calculated by finding the sum of the distances between all of the points in the first distribution and all of the points in the second distribution, and then dividing by the number of points in the first distribution.	earth mover's distance (emd)	Explain earth mover's distance (emd) (machine learning) using an analogy.
Embeddings are a way of representing data in a lower dimensional space. This makes it easier to learn patterns and relationships in the data. Embeddings can be thought of as a way of mapping from a high dimensional space to a lower dimensional space.	embeddings	Explain embeddings (machine learning) using an analogy.
Embedding space is a bit like a map. It takes a list of coordinates (like latitude and longitude) and turns it into a visual representation (like a map). This makes it easier to understand relationships between different points.In machine learning, embedding space is used to create a visual representation of data. This makes it easier to understand relationships between different points.	embedding space	Explain embedding space (machine learning) using an analogy.
Empirical risk minimization is a technique used in machine learning to find the best possible function to fit a given set of data. It is similar to the process of finding the best possible fit for a curve to a set of data points. The curve that best fits the data is the one that has the lowest error (or deviation) between the points and the curve.	empirical risk minimization (erm)	Explain empirical risk minimization (erm) (machine learning) using an analogy.
An encoder is like a translator. It takes a sentence in one language and translates it into another language.	encoder	Explain encoder (machine learning) using an analogy.
An ensemble is like a group of people who all have different skills and knowledge working together to achieve a common goal. The people in the group might have different backgrounds, experiences, and knowledge, but they all work together to achieve the goal. In the same way, an ensemble of machine learning algorithms works together to achieve a common goal. The algorithms in the ensemble use their different skills and knowledge to improve the accuracy of the predictions made by the ensemble.	ensemble	Explain ensemble (machine learning) using an analogy.
If you think of the environment as a classroom, the teacher is the one who is providing the instructions (the training data) and the students are the machines that are learning from the teacher.	environment	Explain environment (machine learning) using an analogy.
Episode is like a movie. It is a sequence of images played one after the other. The first image is the input and the last image is the output. In between, there are a lot of hidden images that are used to create the output.	episode	Explain episode (machine learning) using an analogy.
The epsilon greedy policy is a machine learning algorithm that is similar to the greedy algorithm, but it allows for a small amount of randomness or "epsilon" in order to avoid getting stuck in a local optimum. This analogy might help to understand it: imagine you are a treasure hunter and you are trying to find a treasure chest. The greedy algorithm would be like walking around randomly until you find the treasure chest. The epsilon greedy policy would be like walking around randomly until you find the treasure chest, but then checking to see if there is a better treasure chest somewhere else before you stop searching.	epsilon greedy policy	Explain epsilon greedy policy (machine learning) using an analogy.
Equality of opportunity is like a machine learning algorithm that is trying to learn how to predict a certain outcome. The algorithm is given a set of data points (the input), and it is trying to find a pattern that will allow it to predict the outcome (the output) for future data points. The algorithm is not biased against any of the data points, and it will try to learn from all of them equally.	equality of opportunity	Explain equality of opportunity (machine learning) using an analogy.
Equalized odds is a technique used in machine learning to improve the accuracy of predictions. It does this by adjusting the weight given to different data points, so that all data points are given an equal chance of influencing the prediction. This is done by dividing the data set into two parts - a training set and a test set. The training set is used to learn the model, and the test set is used to evaluate the accuracy of the model. The weight given to each data point is then adjusted so that the accuracy of the model is the same for both the training set and the test set.	equalized odds	Explain equalized odds (machine learning) using an analogy.
If you think of a computer as a giant calculator, then machine learning is like teaching the computer how to do arithmetic. You might show the computer a few examples of addition problems, and then tell it how to solve them. After that, the computer can solve any addition problem you give it, as long as it has enough data to learn from.	example	Explain example (machine learning) using an analogy.
Experience replay is a technique used in machine learning that allows a machine learning algorithm to "remember" past experiences. This is done by storing past experiences in a memory, and then replaying them to the machine learning algorithm. This allows the machine learning algorithm to learn from its past experiences, and improve its performance.	experience replay	Explain experience replay (machine learning) using an analogy.
The experimenter's bias is similar to the bias that humans have when they are judging other humans. We tend to judge others based on our own experiences and what we know. This is called the confirmation bias. We also tend to give more weight to information that confirms our beliefs than information that does not. This is called the sunk cost fallacy.	experimenter's bias	Explain experimenter's bias (machine learning) using an analogy.
The exploding gradient problem is a machine learning problem that occurs when the gradient of the loss function becomes very large as the learning algorithm approaches a local minimum. This can cause the algorithm to "explode" and diverge from the minimum, making it difficult to find the optimal solution.An analogy for the exploding gradient problem would be a person trying to walk down a hill. As they approach the bottom of the hill, the gradient of the slope becomes very large, making it difficult to stay on track.	exploding gradient problem	Explain exploding gradient problem (machine learning) using an analogy.
A fairness constraint is like a speed limit on a road. It is a limit on how fast data can be processed in order to ensure that all data is treated equally.	fairness constraint	Explain fairness constraint (machine learning) using an analogy.
A fairness metric is like a ruler that helps measure how equal or fair a process is. It can help identify when some people are treated unfairly or when some groups of people are not being treated equally.	fairness metric	Explain fairness metric (machine learning) using an analogy.
Federated learning is a machine learning technique where the training data is distributed across multiple machines. The machines work together to learn a common model. This technique is useful for large datasets where it is impractical to store the data on a single machine.	federated learning	Explain federated learning (machine learning) using an analogy.
A feedback loop is like a thermostat in your home. The thermostat is constantly monitoring the temperature and then making small adjustments to the furnace to keep the temperature constant. A feedback loop in machine learning is similar. The computer is constantly monitoring the results of its actions (the "output") and then making small adjustments to its algorithms to improve the accuracy of its predictions.	feedback loop	Explain feedback loop (machine learning) using an analogy.
A feedforward neural network is a bit like a group of people who are each experts in a different subject. The people are seated in a large room, and someone in the middle asks them a question about a subject that they all know something about. Each person in the room then shouts out an answer, and the person in the middle chooses the answer that they think is best.	feedforward neural network (ffn)	Explain feedforward neural network (ffn) (machine learning) using an analogy.
A few-shot learning algorithm is like a person who has only seen a few examples of a particular animal, but is trying to learn what that animal looks like. The person might not be able to identify the animal perfectly, but they will be able to get a good idea of what it looks like based on the few examples they have seen.	few-shot learning	Explain few-shot learning (machine learning) using an analogy.
Fine tuning is like adjusting the focus on a camera. The more you adjust the focus, the more clear the image becomes. In the same way, the more you fine tune a machine learning algorithm, the more accurate its predictions will be.	fine tuning	Explain fine tuning (machine learning) using an analogy.
Forget gate is a machine learning technique that is used to prevent a machine learning algorithm from learning specific information during the training phase. This technique is used to prevent the machine learning algorithm from overfitting the data.	forget gate	Explain forget gate (machine learning) using an analogy.
A softmax function is a way to turn a vector of real values into a vector of probabilities. It works by taking a vector of real values and squashing them down into a vector of probabilities between 0 and 1. This is done by multiplying each value in the vector by a weight and then adding all of the weighted values up. The resulting vector is then normalized so that the sum of all the probabilities is 1.	full softmax	Explain full softmax (machine learning) using an analogy.
A fully connected layer is a type of neural network layer where each neuron in the layer is connected to every other neuron in the layer. This type of layer is often used in deep learning networks.	fully connected layer	Explain fully connected layer (machine learning) using an analogy.
GAN is a machine learning algorithm that is used to generate new data. It is similar to a neural network in that it uses a series of layers to learn and improve its predictions. However, a GAN also includes a feedback loop that allows it to generate new data that is similar to the data it has already learned. This makes it a powerful tool for creating new data sets, which can be used for training other machine learning algorithms.	gan	Explain gan (machine learning) using an analogy.
A generalization is like a stereotype. It is a simplified version of a person or thing.	generalization	Explain generalization (machine learning) using an analogy.
A generalization curve is a graph that plots the accuracy of a machine learning algorithm as it is trained on more and more data. The accuracy of the algorithm is measured by how well it can predict the correct label for new data points. As the algorithm is trained on more data, its accuracy will increase until it reaches a point where adding more data does not improve its accuracy. This point is called the "plateau" of the generalization curve.	generalization curve	Explain generalization curve (machine learning) using an analogy.
A generalized linear model is like a recipe for a cake. You need to know what ingredients to put in, and in what quantities. You also need to follow the recipe closely to make sure the cake turns out correctly.	generalized linear model	Explain generalized linear model (machine learning) using an analogy.
GAN is a machine learning algorithm that is used to generate new data. It is made up of two parts: a generator and a discriminator. The generator is used to create new data, and the discriminator is used to determine if the data is real or fake.	generative adversarial network (gan)	Explain generative adversarial network (gan) (machine learning) using an analogy.
A generative model is like a recipe for a cake. You can use the recipe to make a cake yourself, or you can use it to generate a new cake based on the ingredients you have. A generative model is a way of learning the structure of a data set by example.	generative model	Explain generative model (machine learning) using an analogy.
A generator is like a vending machine. You put in a dollar, and it gives you a candy bar. The generator takes in data (the dollar), and it spits out a prediction (the candy bar).	generator	Explain generator (machine learning) using an analogy.
GPT is a machine learning algorithm that is similar to a transformer network. It is a generative model that is pre-trained on a large amount of data. This allows it to learn the structure of data and to generate new data that is similar to the data that it was trained on.	gpt (generative pre-trained transformer)	Explain gpt (generative pre-trained transformer) (machine learning) using an analogy.
A gradient is like a hill. The higher you go, the more difficult it becomes to climb. The gradient of a function tells you how steep the hill is.	gradient	Explain gradient (machine learning) using an analogy.
Gradient clipping is a technique used in machine learning to prevent a neural network from overfitting the training data. It works by clipping the gradient of the neural network at a certain value. This prevents the neural network from learning the details of the training data and instead allows it to learn the general trend.	gradient clipping	Explain gradient clipping (machine learning) using an analogy.
A greedy policy in machine learning is like a person who is always looking to make the most money possible. This person will take any opportunity to make more money, even if it means sacrificing some of what they have already earned.	greedy policy	Explain greedy policy (machine learning) using an analogy.
Ground truth is the truth as it exists in reality. In machine learning, ground truth is the set of known or assumed facts against which the performance of a machine learning algorithm is measured.	ground truth	Explain ground truth (machine learning) using an analogy.
Group attribution bias is a type of cognitive bias that occurs when people try to explain the behavior of a group as a result of the individual characteristics of its members. This bias can be a problem for machine learning algorithms, which can often be biased towards certain groups of data. For example, if an algorithm is trained on data from a certain region, it may be biased against data from other regions.	group attribution bias	Explain group attribution bias (machine learning) using an analogy.
Hashing is a technique used in machine learning for representing and manipulating data. It can be thought of as a way of converting a large, unordered set of data into a smaller, more ordered set. This is done by creating a hash function, which is a mathematical function that takes a piece of data as input and produces a unique hash value as output. The hash values for all of the data in the set are then stored in a hash table. When a new piece of data is added to the set, its hash value is computed and compared to the values in the hash table. If a match is found, the data is added to the table. If there is no match, the data is added to the end of the table.	hashing	Explain hashing (machine learning) using an analogy.
Heuristic is like a map. It is a guide that helps you find your way.	heuristic	Explain heuristic (machine learning) using an analogy.
Hidden layer is like a filter in photography. It is a layer of software that is used to improve the accuracy of the results of a machine learning algorithm.	hidden layer	Explain hidden layer (machine learning) using an analogy.
Hierarchical clustering is like sorting a pile of leaves. The leaves are first sorted into small piles, and then the small piles are sorted into larger piles.	hierarchical clustering	Explain hierarchical clustering (machine learning) using an analogy.
Hinge loss is a measure of how well a machine learning algorithm is able to predict the correct class for an input. It is calculated by subtracting the prediction error of the algorithm from the true error. The lower the hinge loss, the better the algorithm is at predicting the correct class.	hinge loss	Explain hinge loss (machine learning) using an analogy.
A holdout is like a final exam for a student. The student has been studying all semester for the test, and the test is the final step in proving that the student has learned the material. The student's score on the test is a measure of how well the student has learned the material.	holdout data	Explain holdout data (machine learning) using an analogy.
A hyperparameter is a knob that you can turn to change the way a machine learning algorithm behaves. It's a bit like the settings on your TV - you can change the brightness, the contrast, and the colour saturation to make the picture look the way you want it to.	hyperparameter	Explain hyperparameter (machine learning) using an analogy.
A hyperplane is like a fence that separates two areas of land. In machine learning, a hyperplane is a boundary that separates two classes of data.	hyperplane	Explain hyperplane (machine learning) using an analogy.
I.i.d. is like a recipe for a cake. You need certain ingredients (like eggs, sugar, butter, and flour) and you follow a set of instructions to make the cake. The same recipe will always make the same cake, even if you make it a different number of times.I.i.d. is like that for machine learning. You need a set of training data (like eggs, sugar, butter, and flour) and you follow a set of instructions (like baking the cake at a certain temperature for a certain amount of time) to make a machine learning model. The same machine learning model will always make the same predictions, even if you use it to predict different data.	i.i.d.	Explain i.i.d. (machine learning) using an analogy.
If you want to learn how to ride a bike, you can read a book about it, or you can watch someone else do it. If you watch someone else do it, you can learn how to do it yourself. The same is true for image recognition. If you want a computer to be able to recognize images, you can give it a lot of images to look at and tell it what each one is, or you can show it how to do it itself.	image recognition	Explain image recognition (machine learning) using an analogy.
A dataset is imbalanced when one group of data is much more prevalent than the other. This can be like having a room full of people who are all six feet tall and only one person who is four feet tall. The dataset would be imbalanced because the group of people who are six feet tall is much more prevalent than the group of people who are four feet tall.	imbalanced dataset	Explain imbalanced dataset (machine learning) using an analogy.
Implicit bias is like a computer program that has been designed to do a certain task. The program is not aware of what it is doing, but it is still able to complete the task.	implicit bias	Explain implicit bias (machine learning) using an analogy.
Incompatibility of fairness metrics (machine learning) can be analogized to two people trying to use the same pair of scissors. Each person is trying to cut something different with the scissors, but the blades are not compatible so neither person can cut what they want. In the same way, two different fairness metrics may be trying to measure different things, but they are not compatible so neither metric can accurately measure fairness.	incompatibility of fairness metrics	Explain incompatibility of fairness metrics (machine learning) using an analogy.
I.i.d is like a bunch of students who all got the same grade on their test. They all got the same score because they all studied the same material and were graded on the same scale.	independently and identically distributed (i.i.d)	Explain independently and identically distributed (i.i.d) (machine learning) using an analogy.
When you are learning to drive a car, you are given feedback on how well you are doing. If you make a mistake, the instructor tells you what you did wrong so you can correct it. This feedback is individualized, meaning it is tailored specifically for you. You are not given feedback on how other students are doing.This is similar to how machine learning works. The computer is given feedback on how well it is doing, and it adjusts its behavior accordingly. The feedback is tailored specifically for that computer, and it is not compared to the performance of other computers.	individual fairness	Explain individual fairness (machine learning) using an analogy.
Inference is like a detective coming to a crime scene. The detective looks at the clues (evidence) and tries to figure out what happened. Inference is the process of using data to figure out what is happening in the world.	inference	Explain inference (machine learning) using an analogy.
In-group bias is a type of cognitive bias that involves favoring members of one's own group. This can manifest in a number of ways, such as overestimating the abilities of group members or underestimating the abilities of outsiders. In machine learning, in-group bias can occur when a machine learning algorithm favors data that is similar to data it has already been trained on. This can lead to inaccurate predictions or recommendations, as the algorithm may not be able to learn from data that is dissimilar to what it has already seen.	in-group bias	Explain in-group bias (machine learning) using an analogy.
The input layer is like the foundation of a house. It's what everything else is built on top of. In machine learning, the input layer is the first layer of a neural network. It's where the data is fed in.	input layer	Explain input layer (machine learning) using an analogy.
Interpretability is like being able to read a book. You can understand the story without needing to know the language the book was written in. Machine learning is like being able to read a book in a foreign language. You can understand the story, but you need to know the language the book was written in. Interpretability is the ability to understand what a machine learning model is doing and why.	interpretability	Explain interpretability (machine learning) using an analogy.
Inter-rater agreement is a measure of how well different raters agree on the classification of a given item. In other words, it is a measure of how well different raters can agree on what something is. An analogy for this might be if you had a group of people who were all trying to identify different types of animals. If they all agreed on what each animal was, then their inter-rater agreement would be high. If, however, some people thought that a particular animal was a dog, while others thought it was a cat, then their inter-rater agreement would be lower.	inter-rater agreement	Explain inter-rater agreement (machine learning) using an analogy.
Intersection over Union (IOU) is a measure of how well two sets of data overlap. IOU is calculated by taking the intersection of the two sets (the data that is common to both) and dividing it by the union of the two sets (the data that is in either set). This gives you a number between 0 and 1, with 1 being a perfect match and 0 indicating that the two sets have no overlap.IOU can be used to measure how well two sets of data represent the same thing. For example, if you have a set of data points that represent customer data, and you want to find a new set of data points that represent those customers, you can use IOU to measure how well the two sets match.	intersection over union (iou)	Explain intersection over union (iou) (machine learning) using an analogy.
IOU is a machine learning technique that is used to predict the probability of an event occurring. It is similar to a voting system, where each participant is given a vote, and the most popular option is chosen. In IOU, each participant is given a vote, and the most popular option is chosen. However, in IOU, the participants are machines, and the votes are used to predict the probability of an event occurring.	iou	Explain iou (machine learning) using an analogy.
The item matrix is a table that lists all of the items in a set, along with the number of times each item appears in the set. It can be used to help with machine learning tasks, such as creating a model that can predict the likelihood of an item being chosen.An analogy for the item matrix would be a list of all the items in a store, along with the number of times each item is sold. This could be used to help create a model that predicts the likelihood of an item being chosen by a customer.	item matrix	Explain item matrix (machine learning) using an analogy.
One way to think of machine learning is as a computer’s ability to learn on its own, without being explicitly programmed. Just as a human can learn new things over time, a computer can too, by analyzing data and recognizing patterns. This is done through a process called “training,” in which the computer is fed a large set of data and asked to identify patterns on its own. Once it has been trained, the computer can then use this knowledge to make predictions or decisions in new situations, without being explicitly told what to do.An analogy for this might be a person who has learned how to drive a car. At first, they may have had to be explicitly taught how to drive, step-by-step. But over time, they may have learned how to drive on their own by analyzing the patterns of traffic, road signs, and other drivers. In the same way, a computer can learn how to do things like identify objects in photos or predict stock prices by analyzing data and recognizing patterns.	items	Explain items (machine learning) using an analogy.
Iteration is like when you are baking a cake. You put all the ingredients in a bowl and mix them together. Then you put the batter in a cake pan and bake it. After it is done baking, you put frosting on it and eat it.	iteration	Explain iteration (machine learning) using an analogy.
Keras is a machine learning library that is used to create and train neural networks. It is written in Python and is based on the TensorFlow library. Keras can be used to create deep learning models and is popular with developers because it is easy to use.	keras	Explain keras (machine learning) using an analogy.
One way to think about keypoints is as the locations in an image that are most important for describing that image. For example, in a picture of a cat, the keypoints might be the location of the ears, the location of the eyes, and the location of the tail.	keypoints	Explain keypoints (machine learning) using an analogy.
Kernel support vector machines are a type of machine learning algorithm that are used to predict the probability of something occurring, or the likelihood of something being true. They work by using a kernel function to map the training data into a higher dimensional space, where the data is easier to work with. The algorithm then finds a hyperplane that best separates the data in the higher dimensional space.	kernel support vector machines (ksvms)	Explain kernel support vector machines (ksvms) (machine learning) using an analogy.
K-means is a machine learning algorithm that is used to partition data into clusters. It works by assigning each data point to the cluster that it is most similar to.	k-means	Explain k-means (machine learning) using an analogy.
K-median is a machine learning algorithm that is used to find the optimal location of a k-means cluster. It works by starting with a set of points, and then iteratively moving each point to the location that is closest to the median of all the points in the cluster.	k-median	Explain k-median (machine learning) using an analogy.
Loss is the opposite of gain. In the context of machine learning, it is a measure of how far off the predicted value is from the actual value.	l1 loss	Explain l1 loss (machine learning) using an analogy.
L1 regularization is a technique used in machine learning to prevent overfitting. It works by penalizing models that have a large number of parameters relative to the number of observations. This penalty encourages the model to use only the most important features in its predictions.	l1 regularization	Explain l1 regularization (machine learning) using an analogy.
Loss is a measure of how far off our predictions are from the actual values. It is a way of measuring how well our model is doing. We want our loss to be as low as possible.	l2 loss	Explain l2 loss (machine learning) using an analogy.
L2 regularization is a technique used in machine learning to prevent overfitting. It works by adding a penalty term to the cost function that is proportional to the square of the magnitude of the weights of the model. This penalty term encourages the model to have smaller weights, which makes it less likely to overfit the data.	l2 regularization	Explain l2 regularization (machine learning) using an analogy.
Labeled example is like giving a student a worksheet with questions that are already filled in. The student then uses the worksheet to practice answering the questions.	labeled example	Explain labeled example (machine learning) using an analogy.
Lamda is a bit like a grammar for a foreign language. It helps machines learn how to understand and respond to natural language input.	lamda (language model for dialogue applications)	Explain lamda (language model for dialogue applications) (machine learning) using an analogy.
Lambda is a function that allows you to create a new function by passing in a function as an argument. It's like a black box that takes in an input and spits out a new function.	lambda	Explain lambda (machine learning) using an analogy.
Landmarks in machine learning are similar to landmarks in the real world. They are specific points that are easily identifiable and can be used to help orient oneself. In machine learning, landmarks can be used to identify the location of a particular feature in a dataset or to help determine the best way to approach a problem.	landmarks	Explain landmarks (machine learning) using an analogy.
A language model is a bit like a dictionary. It is a collection of words and their definitions. A machine learning algorithm can use a language model to help it learn how to predict the next word in a sentence.	language model	Explain language model (machine learning) using an analogy.
A large language model is like a dictionary. It is a large collection of words and their definitions.	large language model	Explain large language model (machine learning) using an analogy.
Least squares regression is like trying to find the best line that fits a group of points on a graph. You want the line to be as close to the points as possible, and you want the line to have the smallest possible error.	least squares regression	Explain least squares regression (machine learning) using an analogy.
Linear models are like a slide ruler. You can use them to calculate things by drawing a line between two points.	linear model	Explain linear model (machine learning) using an analogy.
Linear regression is like predicting how a straight line will intersect points on a graph. You can use linear regression to predict how a dependent variable (y) will change when you change an independent variable (x).	linear regression	Explain linear regression (machine learning) using an analogy.
Logistic regression is like a microscope. It can be used to zoom in on small details in a data set. This can help you find patterns and relationships that you might not have been able to see before.	logistic regression	Explain logistic regression (machine learning) using an analogy.
Logits are a bit like the odds of something happening. For example, the odds of flipping a coin and it landing on heads are 1 in 2, or 50%. This is because there are two possible outcomes and only one of them is heads. The logit of this is 0.5.	logits	Explain logits (machine learning) using an analogy.
Log loss is a measure of how close a machine learning model is to predicting the correct value for a given input. It is calculated by taking the negative of the logarithm of the probability of the model predicting the correct value, and is usually expressed in terms of a percentage.An analogy for log loss would be a person trying to guess the weight of a baby. The person would calculate the negative of the logarithm of the probability of guessing the baby's weight correctly, and would express this as a percentage.	log loss	Explain log loss (machine learning) using an analogy.
Log-odds is a measure of how likely a particular event is to happen, similar to how odds are used to measure the likelihood of an event. In log-odds, the logarithm of the odds is used, which makes it easier to compare different events. This measure is often used in machine learning to calculate the probability of a particular event happening.	log-odds	Explain log-odds (machine learning) using an analogy.
LSTMs are a type of recurrent neural network that are particularly good at learning and remembering patterns of data. They work by using a set of memory cells that can store data for a certain amount of time. This allows them to remember patterns of data over long periods of time, which is why they are often used for machine learning tasks such as natural language processing.	long short-term memory (lstm)	Explain long short-term memory (lstm) (machine learning) using an analogy.
The loss curve is like a graph of how well a machine learning algorithm is doing at distinguishing between two types of data. The x-axis is the number of data points the algorithm has seen, and the y-axis is the percentage of data points the algorithm has gotten wrong.	loss curve	Explain loss curve (machine learning) using an analogy.
A loss surface is a three-dimensional graph that shows the relationship between the input and output values of a machine learning algorithm. The surface can be used to determine the best input values for achieving a desired output value.	loss surface	Explain loss surface (machine learning) using an analogy.
LSTM is a machine learning algorithm that is used to predict future events. It is similar to a human brain in that it can remember past events and use that information to predict future events.	lstm	Explain lstm (machine learning) using an analogy.
A majority class is a type of machine learning algorithm that uses a voting system to determine the most common class among a group of classes.	majority class	Explain majority class (machine learning) using an analogy.
A Markov decision process (MDP) is a decision theory tool used in machine learning that helps a decision maker choose the best action to take, given the current state of the world and the decision maker's beliefs about the world. It can be thought of as a "machine learning algorithm" that takes into account the current state of the world, the decision maker's beliefs about the world, and the action the decision maker took in the past, in order to predict the best action to take in the future.	markov decision process (mdp)	Explain markov decision process (mdp) (machine learning) using an analogy.
A machine learning algorithm is like a person. It can only learn if it is given feedback. The markov property says that the machine learning algorithm can only learn from the present and not the past.	markov property	Explain markov property (machine learning) using an analogy.
A masked language model is like a person who is wearing a mask. The person can still see and hear, but other people can't see or hear what the person is saying. The mask protects the person's identity.	masked language model	Explain masked language model (machine learning) using an analogy.
Matplotlib is a machine learning library that allows you to create graphs and charts of your data. It is similar to Microsoft Excel in that it allows you to easily create graphs and charts of your data.	matplotlib	Explain matplotlib (machine learning) using an analogy.
Matrix factorization is a machine learning technique that is used to decompose a matrix into a product of two matrices. The first matrix is a lower triangular matrix and the second matrix is an upper triangular matrix. The lower triangular matrix is typically called the "factor matrix" and the upper triangular matrix is typically called the "cofactor matrix".	matrix factorization	Explain matrix factorization (machine learning) using an analogy.
Meta-learning is like learning how to learn. It is a way of teaching a machine learning algorithm how to learn from data so that it can improve its performance over time.	meta-learning	Explain meta-learning (machine learning) using an analogy.
The tf.metrics API is a way to measure the progress of a machine learning algorithm as it trains. It works by keeping track of a set of "metrics" values, which can be anything from the number of correct predictions made to the amount of time the algorithm has been running. The API allows you to query these metrics at any point in the training process, so you can see how the algorithm is doing and make adjustments as needed.An analogy for this might be keeping track of a runner's progress as they train for a marathon. The runner would track things like how many miles they've run, how long it took them to run those miles, and how many calories they've burned. This information would help them track their progress and make adjustments to their training plan as needed.	metrics api (tf.metrics)	Explain metrics api (tf.metrics) (machine learning) using an analogy.
Mini-batch is like getting a small scoop of ice cream instead of a large one. You get to try a little bit of each flavor and find the one you like the best.	mini-batch	Explain mini-batch (machine learning) using an analogy.
Mini-batch stochastic gradient descent is a machine learning algorithm that works similarly to how a person might learn from a small set of examples. Imagine that you are trying to learn new information about a topic, like how to ride a bike. If you only have one example to learn from, it would be very difficult to understand the concept. However, if you have a small set of examples to learn from, you can start to see patterns and figure out how to ride a bike. Mini-batch stochastic gradient descent works in a similar way. It uses a small set of data to learn from, which makes it easier to understand the concept and improve the algorithm.	mini-batch stochastic gradient descent	Explain mini-batch stochastic gradient descent (machine learning) using an analogy.
The minimax loss is the amount of money you would lose if you played a game where you could only lose $1,000,000, and you had to choose between two options. The first option is to play a game where you could lose $1,000,000, but you have a 50% chance of winning $2,000,000. The second option is to play a game where you could lose $2,000,000, but you have a 50% chance of winning $4,000,000. In this analogy, the first option is the minimax loss, because it is the option that will cause you to lose the least amount of money.	minimax loss	Explain minimax loss (machine learning) using an analogy.
A minority class is a group of data points in a machine learning dataset that is not well represented by the majority class. This can be due to a number of factors, such as the minority class being under-sampled or having a different distribution from the majority class.	minority class	Explain minority class (machine learning) using an analogy.
Machine learning is like a computer program that is able to learn how to do things on its own by analyzing data. It is similar to how a human baby learns to walk and talk. The baby observes what people do and then tries to do the same things. The baby also listens to people talk and tries to imitate the sounds that it hears.	ml	Explain ml (machine learning) using an analogy.
Mnist is a machine learning algorithm that is used to predict whether or not an image is a picture of a handwritten digit. It works by taking a picture of a handwritten digit and then using that picture to create a model that can predict whether or not future pictures are of handwritten digits.	mnist	Explain mnist (machine learning) using an analogy.
Modality is like a teacher. The teacher is always there to help you learn and guide you in the right direction. The teacher is always there to help you understand the material and answer any questions you may have.	modality	Explain modality (machine learning) using an analogy.
A model capacity is the maximum number of items that a machine learning model can remember and use to make predictions. It is similar to the amount of data that can be stored on a computer's hard drive.	model capacity	Explain model capacity (machine learning) using an analogy.
A model parallelism analogy for machine learning is as follows:Just as a group of people can work together on a project faster than one person can work on the project alone, a group of computers can work together on a machine learning project faster than one computer can work on the project alone. By splitting the work up among multiple machines, the time it takes to complete the project is reduced.	model parallelism	Explain model parallelism (machine learning) using an analogy.
Model training is like teaching a dog how to fetch a ball. The dog is the model, the ball is the input, and the act of fetching the ball is the desired outcome. The model is trained by providing it with many examples of input-output pairs. For each input, the model is asked to predict the desired outcome. The model then "learns" by adjusting its internal parameters so that its predictions match the desired outcomes as closely as possible.	model training	Explain model training (machine learning) using an analogy.
Momentum is like a snowball rolling down a hill. The faster it rolls, the more momentum it has. The more momentum it has, the more likely it is to keep rolling.	momentum	Explain momentum (machine learning) using an analogy.
Multi-class classification is like sorting a deck of cards. There are many different ways to sort a deck of cards, but the most common are by suit (clubs, diamonds, hearts, spades) and by rank (A, 2, 3, 4, etc.). You can also sort a deck of cards by color (red, black, blue), by shape (circle, square, triangle), or by any other attribute you can think of.	multi-class classification	Explain multi-class classification (machine learning) using an analogy.
Multi-class logistic regression is similar to regular logistic regression, but it is used to predict a categorical outcome variable with more than two categories. The algorithm works by trying to find a line that best splits the data into two groups, one with a higher probability of belonging to one category, and the other with a higher probability of belonging to a different category.	multi-class logistic regression	Explain multi-class logistic regression (machine learning) using an analogy.
Multi-head self-attention is a machine learning technique that is used to improve the accuracy of predictions made by a neural network. It works by allowing the network to "attend" to multiple parts of the input data at the same time, which helps it to learn the relationships between different parts of the data more effectively. This analogy might help to explain how it works:Imagine that you are trying to learn about a new subject, but you only have access to a few pieces of information about it. If you try to learn about the subject by only looking at these pieces of information, you will probably be able to understand some of the things that it is made up of, but you will not be able to see the relationships between them. However, if you can look at the information in several different ways, you will be able to understand it better. This is the same thing that happens with multi-head self-attention. By looking at the input data in several different ways, the network is able to understand the relationships between different parts of it better, which leads to more accurate predictions.	multi-head self-attention	Explain multi-head self-attention (machine learning) using an analogy.
Multimodal model is like a group of people who are learning a new language together. Each person in the group uses a different method to learn the language (e.g. listening, speaking, writing, reading). The multimodal model combines the different methods used by the group to learn the new language.	multimodal model	Explain multimodal model (machine learning) using an analogy.
Multinomial classification is a machine learning technique used to predict the category a given observation belongs to. This is done by training a model on a set of data that has been labeled with the correct category for each observation. The model is then used to predict the category for new observations.	multinomial classification	Explain multinomial classification (machine learning) using an analogy.
Multinomial regression is a machine learning technique used to predict a categorical variable. It is similar to logistic regression, but instead of predicting a binary outcome, it predicts a categorical variable with more than two outcomes. Multinomial regression works by estimating the probability of each outcome occurring, given the predictor variables.	multinomial regression	Explain multinomial regression (machine learning) using an analogy.
Nan traps are like a very small, very sensitive trap that can be used to catch very small creatures. The traps can be set to catch a specific type of creature, and can be very accurate in doing so.	nan trap	Explain nan trap (machine learning) using an analogy.
Natural language understanding is like teaching a computer to understand what you are saying. You are the teacher, and the computer is the student. You need to teach the computer the different words and how they are used. You also need to teach the computer how to put the words together to form sentences.	natural language understanding	Explain natural language understanding (machine learning) using an analogy.
A negative class in machine learning is like a group of people who are trying to learn a new skill, but are struggling. The negative class is made up of people who are not very good at the skill and are making a lot of mistakes.	negative class	Explain negative class (machine learning) using an analogy.
A neural network is a bit like the human brain. It can learn how to do things by itself, like recognizing objects or words. It can also learn how to do things by being told what to do, like adding numbers.	neural network	Explain neural network (machine learning) using an analogy.
A neuron is a machine learning algorithm that is inspired by the workings of the brain. It is a type of artificial neural network that is used to learn how to recognize patterns.	neuron	Explain neuron (machine learning) using an analogy.
N-gram is a machine learning technique that is used to predict the next word in a text. It works by breaking a text into small pieces and then predicting the next word based on the previous words.	n-gram	Explain n-gram (machine learning) using an analogy.
Nlu is a bit like a human brain. It is a system that can learn from experience and make predictions. It can do this by recognizing patterns in data.	nlu	Explain nlu (machine learning) using an analogy.
Non-response bias is like when you ask someone a question and they don't answer. It's possible that they don't know the answer, they don't want to answer, or they're not interested in the question.	non-response bias	Explain non-response bias (machine learning) using an analogy.
The optimizer is like a personal trainer for your machine learning model. It helps the model learn how to best achieve its goals by providing feedback and adjusting its behavior as it trains.	optimizer	Explain optimizer (machine learning) using an analogy.
The out-group homogeneity bias is a cognitive bias that occurs when people are more likely to remember the similarities of people in their own group than the similarities of people in other groups. This bias can be seen in machine learning when algorithms are more likely to remember the similarities of data within a certain group than the similarities of data across groups.	out-group homogeneity bias	Explain out-group homogeneity bias (machine learning) using an analogy.
Parameter update is like a teacher giving a student feedback on their work. The teacher might tell the student what they did well, and then give suggestions on how they could improve. In the same way, parameter update tells the machine learning algorithm what it did well, and then gives suggestions on how it could improve.	parameter update	Explain parameter update (machine learning) using an analogy.
A partial derivative is a way of measuring how one variable in a function changes when another variable is changed. It's a bit like taking a slice through a function and looking at how the value of the function changes at that point.	partial derivative	Explain partial derivative (machine learning) using an analogy.
One example of a bias in machine learning is the so-called "participation bias". This is the tendency of a machine learning algorithm to be more likely to learn from examples that are more easily available to it. For example, a machine learning algorithm might be more likely to learn the correct spelling of a word if it is given a list of words that are all easily found in a dictionary, than if it is given a list of words that are all spelled incorrectly.	participation bias	Explain participation bias (machine learning) using an analogy.
One way to think of partitioning is as if you are cutting a pie into pieces. Each piece of the pie is a partition. You can then put different toppings on each piece of the pie. The toppings represent the different algorithms that you can use on your data.	partitioning strategy	Explain partitioning strategy (machine learning) using an analogy.
A perceptron is a bit like a brain. It can learn how to do things by itself by looking at examples. It can also forget what it has learned, just like a brain can forget things.	perceptron	Explain perceptron (machine learning) using an analogy.
Performance (machine learning) can be thought of as the speed of your computer. The faster your computer is, the faster it can process information and the faster it can learn.	performance	Explain performance (machine learning) using an analogy.
Perplexity is a measure of how well a machine learning algorithm can learn a task. It is a measure of how much information the algorithm needs to learn the task.	perplexity	Explain perplexity (machine learning) using an analogy.
A pipeline is like a conveyor belt in a factory. The belt carries objects from one machine to the next, where they are processed and then sent on their way. In a machine learning pipeline, the first machine (the “input”) takes in data, the second machine (the “model”) processes it, and the third machine (the “output”) produces the results.	pipeline	Explain pipeline (machine learning) using an analogy.
Pipelining is like a conveyor belt in a factory. The belt moves objects from one machine to the next, so that each machine can work on the object as soon as it is available. In machine learning, pipelining means that the computer can work on several tasks at the same time. For example, it can train several models at the same time, or it can evaluate several candidates for a job at the same time.	pipelining	Explain pipelining (machine learning) using an analogy.
A policy is like a set of rules that a machine learning algorithm can use to make decisions. The policy can be something as simple as a list of rules that a machine learning algorithm can use to decide whether or not to approve a loan, or it can be something more complex that takes into account a variety of factors.	policy	Explain policy (machine learning) using an analogy.
Pooling is a technique used in machine learning for data pre-processing. It is a way of reducing the dimensionality of a dataset by combining similar features together. This is done by taking a set of features, usually of the same size, and combining them into a single feature. This new feature is then used in the machine learning algorithm.	pooling	Explain pooling (machine learning) using an analogy.
Positive class is like a teacher in a classroom. The teacher is responsible for teaching the class and helping students learn. The positive class is also responsible for identifying incorrect answers and helping the class learn from their mistakes.	positive class	Explain positive class (machine learning) using an analogy.
Post-processing is like cleaning your house after a party. You've already invited people over, they've shown up, and now you're cleaning up the mess. Machine learning is like the party. It's the process of learning from data. Pre-processing is like cleaning up your house before the party. It's the process of getting your house ready for the party.	post-processing	Explain post-processing (machine learning) using an analogy.
The area under the pr curve is a measure of how likely a machine learning algorithm is to correctly predict a given outcome, given a set of training data. It can be thought of as a measure of how well the algorithm has learned from past experience.	pr auc (area under the pr curve)	Explain pr auc (area under the pr curve) (machine learning) using an analogy.
Precision-recall curve is a graphical representation of how well a machine learning algorithm is able to predict the true positive rate (precision) and recall rate at different thresholds. The curve is typically generated by plotting the precision against the recall for different threshold values.	precision-recall curve	Explain precision-recall curve (machine learning) using an analogy.
Machine learning is like a person learning to predict the outcome of a coin flip. Initially, the person is unsure of the outcome, but with practice, the person becomes better at predicting the outcome. Similarly, machine learning algorithms are initially unsure of the outcome of a particular task, but with practice, they become better at predicting the outcome.	prediction	Explain prediction (machine learning) using an analogy.
A person who is biased towards a particular outcome is like a machine learning algorithm that is biased towards a particular outcome. The person is not looking at all the evidence objectively, and is only looking for evidence that confirms their pre-existing belief. The machine learning algorithm is doing the same thing. It is only looking at the data that confirms its pre-existing belief that the outcome it is trying to predict is most likely to happen.	prediction bias	Explain prediction bias (machine learning) using an analogy.
Predictive parity is a bit like a weather forecast. The forecast doesn't tell you what the weather will be like tomorrow, but it can give you a good idea of what the weather is likely to be like. In the same way, predictive parity can tell you what the likelihood is that a particular event will happen, but it can't tell you for sure what will happen.	predictive parity	Explain predictive parity (machine learning) using an analogy.
Predictive rate parity is a bit like a car insurance company trying to predict how many accidents will happen in a given area in a given month. The company can look at past data on accidents in that area and use that data to create a model that will help them predict how many accidents will happen in that area in the future.	predictive rate parity	Explain predictive rate parity (machine learning) using an analogy.
Preprocessing is like cleaning a dirty window. The window is covered in dirt and grime, and the only way to see through it is to clean it. Preprocessing is the first step in machine learning, and it cleans the data so that the machine can see it more clearly.	preprocessing	Explain preprocessing (machine learning) using an analogy.
Pre-trained models are a bit like a bicycle. Once you know how to ride a bike, it's much easier to learn how to ride a unicycle. A pre-trained model is a machine learning model that has been previously trained on a large dataset. This dataset can be used to "bootstrap" the training of a new machine learning model.	pre-trained model	Explain pre-trained model (machine learning) using an analogy.
I think of it as a computer trying to learn how to play a game like chess. The computer starts by playing a lot of games against itself, and it records which moves lead to victory and which moves lead to defeat. Over time, the computer gets better and better at playing chess, because it is able to learn from its mistakes.	prior belief	Explain prior belief (machine learning) using an analogy.
A probabilistic regression model is like a teacher. The teacher has a lot of information about different students in her class. She also knows a lot about different subjects. The teacher can use this information to predict how well a student will do in a subject, based on how well the student has done in other subjects.	probabilistic regression model	Explain probabilistic regression model (machine learning) using an analogy.
Proxy (sensitive attributes) is like a security guard for your data. It is a technique that is used to protect sensitive information by hiding it in a more general data set. This makes it difficult for someone to learn the sensitive information by studying the data set.	proxy (sensitive attributes)	Explain proxy (sensitive attributes) (machine learning) using an analogy.
Proxy labels are like a cheat sheet for a machine learning algorithm. They are a list of real-world examples that the algorithm can use to learn how to correctly classify new data. For example, if you are teaching a machine learning algorithm to recognize different types of animals, you might use a proxy label for a lion as an example of a big cat. This will help the algorithm learn how to correctly identify lions in new data.	proxy labels	Explain proxy labels (machine learning) using an analogy.
The q-function is a measure of how good a machine learning algorithm is at discriminating between different classes of data. It is analogous to the quality of a wine, with a higher q-function indicating a better ability to correctly identify different types of wine.	q-function	Explain q-function (machine learning) using an analogy.
Q-learning is a machine learning algorithm that is used to learn how to perform a task, such as playing a game or controlling a robot. It works by trying to find a sequence of actions that will lead to the desired outcome. The algorithm starts by trying a random sequence of actions, and then it adjusts its sequence based on how successful it was in achieving the desired outcome.	q-learning	Explain q-learning (machine learning) using an analogy.
Random forest is a machine learning algorithm that is used to predict the outcome of a certain event. It works by creating a bunch of decision trees and then averaging their predictions together. This is a really good algorithm for predicting the outcome of events because it is resistant to overfitting.	random forest	Explain random forest (machine learning) using an analogy.
Random policy is like flipping a coin to make a decision. You have a 50% chance of making the right decision, but you won't know which decision is the right one until you try it.	random policy	Explain random policy (machine learning) using an analogy.
A rater is a machine learning algorithm that is used to predict the quality of a piece of content. It works by analyzing a large number of pieces of content that have been rated by humans, and then using that data to create a model that can predict how good a new piece of content is likely to be.	rater	Explain rater (machine learning) using an analogy.
A person’s taste in books, music, or movies can be thought of as a “recommendation system.” If you’ve ever seen a list of books, music, or movies that someone has recommended to you, then you’ve seen a recommendation system in action.A person’s taste in books, music, or movies can be thought of as a “recommendation system.” If you’ve ever seen a list of books, music, or movies that someone has recommended to you, then you’ve seen a recommendation system in action.	recommendation system	Explain recommendation system (machine learning) using an analogy.
A rectified linear unit (relu) is a type of activation function used in artificial neural networks. It is a nonlinear function that maps a vector of input values to a single output value. It is similar to a linear function, but it has a "squashing" effect that limits the range of input values that can be used. This makes it a good choice for networks that are trying to learn how to recognize patterns in data.	rectified linear unit (relu)	Explain rectified linear unit (relu) (machine learning) using an analogy.
A recurrent neural network (RNN) is a machine learning algorithm that uses feedback loops to learn and predict patterns in data. It can be thought of as a “memory” for a computer, which allows it to learn and remember sequences of information. This makes RNNs particularly well-suited for tasks such as natural language processing and machine translation.	recurrent neural network	Explain recurrent neural network (machine learning) using an analogy.
A regression model is like a recipe for a cake. You need to know the ingredients and how much of each to use. You also need to know how to put them all together. The recipe is a model that can be used to make a cake every time.	regression model	Explain regression model (machine learning) using an analogy.
A regularization rate is like a speed limit. It is a number that tells you how fast you can go without getting a ticket.	regularization rate	Explain regularization rate (machine learning) using an analogy.
Reinforcement learning is like teaching a dog how to fetch a ball. At first, the dog might not know what to do, but if you keep rewarding it for fetching the ball, it will eventually learn how to do it. In reinforcement learning, the computer is constantly trying different things and learning from the rewards it receives.	reinforcement learning (rl)	Explain reinforcement learning (rl) (machine learning) using an analogy.
A replay buffer is like a video recorder for a computer. It records the last several minutes (or hours) of activity on the computer so that it can be played back later. This is useful for debugging programs, or for reviewing what happened on the computer in the past.	replay buffer	Explain replay buffer (machine learning) using an analogy.
Reporting bias is like a person who is only looking for good news and only reporting good news. This is a problem because it skews the data and makes it inaccurate.	reporting bias	Explain reporting bias (machine learning) using an analogy.
Representation in machine learning is similar to the way a map represents a geographic area. A map can be used to show different types of information, such as the location of roads, rivers, and mountains, or the population density of an area. Similarly, a machine learning representation can be used to show different types of information, such as the location of objects in an image or the distribution of words in a text.	representation	Explain representation (machine learning) using an analogy.
Re-ranking is like being a judge at a beauty pageant. You are given a list of contestants, and you have to rank them from 1st to 10th. But then, someone comes along and tells you that you should rank the contestants from 1st to 5th. So, you have to go back and re-rank all of the contestants.	re-ranking	Explain re-ranking (machine learning) using an analogy.
Return in machine learning is similar to earning a return on an investment. Just as you expect to earn a certain percentage on your money each year by investing it in a solid stock or bond, you expect to see a certain percentage of improvement in the accuracy of your predictions as you keep using a machine learning algorithm on a data set. The percentage of improvement you see is called the “return on investment” or “ROI” for machine learning.	return	Explain return (machine learning) using an analogy.
Rewards in machine learning are akin to a teacher's positive reinforcement in a classroom. When a student does something correctly, the teacher might give that student a piece of candy or a pat on the back. In the same way, a machine learning algorithm is "rewarded" when it correctly predicts an outcome. This reinforcement helps the algorithm learn and improve its predictions over time.	reward	Explain reward (machine learning) using an analogy.
Ridge regularization is a technique used in machine learning to prevent overfitting of a model to the training data. It does this by adding a penalty term to the cost function that is used to optimize the model, which encourages the model to be more conservative in its predictions. This penalty term is proportional to the magnitude of the ridge in the data, so that models that are more likely to overfit are penalized more.	ridge regularization	Explain ridge regularization (machine learning) using an analogy.
A rnn is like a teacher. The teacher can see the past, present, and future. The teacher can help you learn and remember things.	rnn	Explain rnn (machine learning) using an analogy.
The rmse is the average distance between the predicted values and the actual values. It is a measure of how accurate the predictions are.	root mean squared error (rmse)	Explain root mean squared error (rmse) (machine learning) using an analogy.
Rotational invariance is a property of certain machine learning algorithms that allows them to learn patterns in data without being affected by changes in orientation or scale. This is analogous to the way that a human brain can learn patterns in data regardless of the angle or size of the objects involved.	rotational invariance	Explain rotational invariance (machine learning) using an analogy.
Sampling bias is like when you only ask your friends for their opinion on something. You are not getting a good representation of the population because you are only getting the opinions of people who are your friends. This is not a good way to make a decision because you are not getting all of the information.	sampling bias	Explain sampling bias (machine learning) using an analogy.
A scalar is a single number, like the temperature on a given day. In machine learning, scalars are used to represent the strength of a particular feature in a dataset. For example, if you were measuring the temperature on different days, you might create a scalar to represent the average temperature for each day.	scalar	Explain scalar (machine learning) using an analogy.
Scaling is like making a cake. You need to use the same recipe, but you can use different size pans. The same is true for machine learning. You need to use the same algorithm, but you can use different size data sets.	scaling	Explain scaling (machine learning) using an analogy.
Scikit-learn is like a teacher. It helps you learn how to do things on your own.	scikit-learn	Explain scikit-learn (machine learning) using an analogy.
Scoring in machine learning is similar to the way points are awarded in a game like basketball. In basketball, players score points by throwing the ball through a hoop. In machine learning, algorithms score points by correctly predicting outcomes. The more accurate the predictions, the more points the algorithm scores.	scoring	Explain scoring (machine learning) using an analogy.
A person who is looking for a new job may only look at job postings that are online. This would be an example of selection bias, because the person is not looking at all the jobs that are available. This would mean that they are not getting the best possible job for them.	selection bias	Explain selection bias (machine learning) using an analogy.
Self-attention is a layer in a machine learning model that helps the model focus on specific parts of the input data. This layer is similar to the way that humans focus on specific parts of a scene when they are looking around.	self-attention (also called self-attention layer)	Explain self-attention (also called self-attention layer) (machine learning) using an analogy.
Self-supervised learning is a bit like learning to ride a bike. You can watch someone else do it, but you'll learn faster if you get on the bike and try it yourself. The same is true for machines. They can learn from data, but they learn faster and better if they can also learn from their own mistakes.	self-supervised learning	Explain self-supervised learning (machine learning) using an analogy.
Self-training is like teaching a computer how to recognize objects in pictures. You show the computer a lot of pictures of different objects, and then tell the computer what each object is. After a while, the computer will be able to recognize objects in pictures all by itself.	self-training	Explain self-training (machine learning) using an analogy.
Semi-supervised learning is like a teacher who is only partially familiar with the subject they are teaching. The teacher can still help the student learn by providing some guidance, but the student also needs to do some of the work on their own.	semi-supervised learning	Explain semi-supervised learning (machine learning) using an analogy.
Sensitive attribute is like a person's Social Security number. It is something that is used to identify a person, and it is considered sensitive information.	sensitive attribute	Explain sensitive attribute (machine learning) using an analogy.
Sentiment analysis is like a human using their brain to read and understand the emotions in a sentence. A machine learning algorithm is used to analyze a large number of training data examples and learn how to identify the sentiment (positive, negative, or neutral) in a sentence.	sentiment analysis	Explain sentiment analysis (machine learning) using an analogy.
Sequence model is like a recipe. You have a list of ingredients and a set of instructions on how to put them together. You follow the instructions to make a cake. A machine learning algorithm is like a cook. It takes the recipe and the ingredients and cooks up a cake.	sequence model	Explain sequence model (machine learning) using an analogy.
Sequence-to-sequence task is like learning a new language. You are given a set of sentences in one language, and your task is to learn how to generate new sentences in that language, based on the ones you are given.	sequence-to-sequence task	Explain sequence-to-sequence task (machine learning) using an analogy.
Serving is like a waiter in a restaurant. The waiter takes the order from the customer and brings the food to the table.	serving	Explain serving (machine learning) using an analogy.
A shape tensor is a bit like a map of an area. It can show you the different shapes in a particular area, as well as how big they are and how close they are to each other.	shape (tensor)	Explain shape (tensor) (machine learning) using an analogy.
The sigmoid function is a mathematical function that is used in machine learning to model the probability of an event occurring. It is similar to the logistic function, which is also used to model probabilities. The sigmoid function can be thought of as a "squished" version of the logistic function. It is used to model the probability of an event occurring by taking into account the likelihood of the event happening and the likelihood of the event not happening.	sigmoid function	Explain sigmoid function (machine learning) using an analogy.
Similarity measure is like comparing two different types of ice cream. You might think that mint chocolate chip ice cream is similar to chocolate ice cream because they are both chocolate flavored. However, you might also think that mint chocolate chip ice cream is similar to peppermint ice cream because they are both mint flavored.	similarity measure	Explain similarity measure (machine learning) using an analogy.
In mathematics, size invariance is the property of a transformation that preserves the size of objects. In other words, the size of the object is unchanged after the transformation.In machine learning, size invariance is the ability of a machine learning algorithm to learn from data of different sizes. In other words, the size of the data is unchanged after the machine learning algorithm has learned from it.	size invariance	Explain size invariance (machine learning) using an analogy.
Sketching is a way of understanding a complex problem by breaking it down into smaller, more manageable pieces. It is similar to machine learning in that it allows you to understand how a system works by understanding the individual parts that make it up.	sketching	Explain sketching (machine learning) using an analogy.
A softmax function is a way to normalize a set of probabilities so that they add up to 1. It is used in machine learning to calculate the probability that a particular input will result in a particular output.An analogy for the softmax function would be a set of weights that are used to balance a set of scales. The weights are adjusted until the scales are perfectly balanced. In the same way, the softmax function adjusts the probabilities until they are all equal.	softmax	Explain softmax (machine learning) using an analogy.
Sparse feature is a machine learning technique that helps reduce the number of features in a dataset while preserving the accuracy of the predictions. It is similar to the way that humans use only a few features to identify someone they know, such as their hair color, height, and build.	sparse feature	Explain sparse feature (machine learning) using an analogy.
Sparse representation is a machine learning technique that is used to represent data using a small number of coefficients. This technique is often used to represent images and text.	sparse representation	Explain sparse representation (machine learning) using an analogy.
A sparse vector is like a library book. It is only borrowed by a few people at a time and is not always in use.	sparse vector	Explain sparse vector (machine learning) using an analogy.
Sparsity is a measure of how many of the entries in a matrix are zero. It is a property of a matrix that can be exploited in machine learning algorithms to speed up the learning process.Imagine you have a very large matrix with millions of entries. If most of the entries are zero, that means that most of the data in the matrix is not important. The machine learning algorithm can ignore all of the entries that are zero and focus only on the non-zero entries, which is much faster and requires less memory.	sparsity	Explain sparsity (machine learning) using an analogy.
Spatial pooling is a technique used in machine learning, specifically in convolutional neural networks, to reduce the number of parameters and computations in a network. It is similar to the process of averaging, but instead of averaging values across a set of neurons, the values are averaged across a set of spatial locations. This technique is used to reduce the complexity of the network and improve performance.	spatial pooling	Explain spatial pooling (machine learning) using an analogy.
If you think of the hinge loss as a penalty for getting a question wrong on a test, then squared hinge loss would be like getting penalized twice for getting a question wrong.	squared hinge loss	Explain squared hinge loss (machine learning) using an analogy.
Squared loss is a measure of how far a machine learning algorithm is from perfect predictions. It is calculated by taking the difference between the predicted value and the actual value, squaring it, and then summing all of the squares. This measure allows you to compare different algorithms and determine which is most accurate.	squared loss	Explain squared loss (machine learning) using an analogy.
Staged training is like learning to drive a car. The first step is to learn the basic controls: how to start the car, how to steer, how to brake, and how to accelerate. Once you know the basic controls, you can start driving around a parking lot. Once you are comfortable driving in a parking lot, you can start driving on city streets. And once you are comfortable driving in city streets, you can start driving on the highway.	staged training	Explain staged training (machine learning) using an analogy.
A state machine is like a computer. It has a number of different states that it can be in, and it can change from one state to another in response to different inputs.	state	Explain state (machine learning) using an analogy.
The state-action value function is like a map that tells you the best route to take from one location to another. It takes into account the current state of the system and the action you plan to take, and calculates the best possible outcome of taking that action in that state.	state-action value function	Explain state-action value function (machine learning) using an analogy.
Static model is like a car. It has a fixed structure and can only be used for a specific purpose.	static model	Explain static model (machine learning) using an analogy.
Stationarity is a property of a time series in which the statistical properties of the series are constant over time. This means that the mean, variance, and autocorrelation of the series are all constant. An analogy for stationarity would be a car that always travels at the same speed and always follows the same path.	stationarity	Explain stationarity (machine learning) using an analogy.
Machine learning is like a computer program that is able to learn on its own by analyzing data. It is able to improve its performance over time by increasing its ability to recognize patterns in data. This is similar to how humans learn, by observing and analyzing patterns in the world around them.	step	Explain step (machine learning) using an analogy.
A step size is like the pace you set for a walk. It determines how often you take a step.	step size	Explain step size (machine learning) using an analogy.
SGD is like hiking up a hill. You take a step forward, then look at the surrounding landscape and see if you can take a better step forward based on what you see. If not, you take a step back.	stochastic gradient descent (sgd)	Explain stochastic gradient descent (sgd) (machine learning) using an analogy.
Stride is the distance between two points in a data set. It is used to measure how much the data changes between each point. Stride can be used to determine how well a machine learning algorithm is able to learn from data.	stride	Explain stride (machine learning) using an analogy.
Structural risk minimization is a machine learning technique used to improve the accuracy of predictions by reducing the impact of noise on the training data. It is similar to regularization, which is also used to improve the accuracy of predictions by reducing the impact of noise on the training data. However, regularization focuses on the size of the model, while structural risk minimization focuses on the structure of the model.	structural risk minimization (srm)	Explain structural risk minimization (srm) (machine learning) using an analogy.
Subsampling is like when you are at a buffet and you only take a small plate of food instead of a large plate. This is because you want to try a little bit of everything instead of filling up on one thing. In machine learning, subsampling is when you only take a small sample of data instead of the entire data set. This is done to save time and resources.	subsampling	Explain subsampling (machine learning) using an analogy.
Supervised machine learning is like giving a child a set of flashcards with pictures on them. The child is then shown a picture and is asked to identify it. After a while, the child will be able to identify most of the pictures without needing to be shown the picture again. Supervised machine learning works in a similar way. The computer is given a set of data (the pictures) and is then asked to identify patterns in the data. After a while, the computer will be able to identify patterns without needing to be shown the data again.	supervised machine learning	Explain supervised machine learning (machine learning) using an analogy.
A synthetic feature is a bit like a recipe. You might have a list of ingredients, and then a set of instructions on how to put them all together. The instructions might tell you to mix some of the ingredients together, and then bake them in the oven.In machine learning, a synthetic feature is a bit like a recipe too. You might have a list of ingredients, and then a set of instructions on how to put them all together. The instructions might tell you to mix some of the ingredients together, and then use a computer to figure out how to bake them in the oven.	synthetic feature	Explain synthetic feature (machine learning) using an analogy.
Tabular q-learning is a machine learning technique that is similar to the way humans learn. The technique uses a table (or matrix) to store information about how well a particular action performs in a particular situation. This information is used to calculate the best action to take in a particular situation.	tabular q-learning	Explain tabular q-learning (machine learning) using an analogy.
Target is like a teacher. It is responsible for teaching a machine how to learn.	target	Explain target (machine learning) using an analogy.
Target network is like a group of people who are trying to learn how to hit a target. They will keep trying to hit the target and eventually they will hit it.	target network	Explain target network (machine learning) using an analogy.
The termination condition is like the finish line in a race. The machine learning algorithm stops when it reaches the termination condition.	termination condition	Explain termination condition (machine learning) using an analogy.
Time series analysis is like predicting the future based on the past.	time series analysis	Explain time series analysis (machine learning) using an analogy.
A timestep is like a single frame in a movie. Just as each frame in a movie captures a small slice of time, each timestep in a machine learning algorithm captures a small slice of data.	timestep	Explain timestep (machine learning) using an analogy.
A token is like a ticket that allows you to ride a bus. The token is like a machine learning algorithm, it is a representation of the data that is being used to learn the model.	token	Explain token (machine learning) using an analogy.
Training is like teaching a dog how to sit. You show the dog how to sit and then give it a treat when it does it correctly. After a while, the dog will automatically sit when you ask it to without needing to be shown how again.	training	Explain training (machine learning) using an analogy.
Trajectory is like a map of your journey. It tells you where you have been and where you are going.	trajectory	Explain trajectory (machine learning) using an analogy.
A transformer is a machine learning algorithm that is used to increase the accuracy of predictions made by a model. It works by taking a model that has been trained on a set of data and then using it to predict the outcomes of new data. The transformer then uses a technique called "learning to learn" to improve the accuracy of its predictions. This involves using a set of data that has been labeled with the correct outcomes to train a new model. This model is then used to predict the outcomes of new data, and the transformer uses the results to improve the accuracy of its predictions.	transformer	Explain transformer (machine learning) using an analogy.
A machine learning algorithm is like a slide ruler. No matter how you move the ruler, the distance between any two points remains the same.	translational invariance	Explain translational invariance (machine learning) using an analogy.
A trigram is like a three-word sentence. It is a unit of text that is three words long.	trigram	Explain trigram (machine learning) using an analogy.
A true negative is like when you press the "no" button on a vending machine. It means that the machine correctly identified that you didn't want a drink and it didn't give you one.	true negative (tn)	Explain true negative (tn) (machine learning) using an analogy.
A true positive is when a test result says that you have a disease, and you actually have the disease.	true positive (tp)	Explain true positive (tp) (machine learning) using an analogy.
The true positive rate is the percentage of positive examples that a machine learning algorithm correctly identifies as being positive. It is a measure of how well the algorithm is able to identify the positive examples in the data set.	true positive rate (tpr)	Explain true positive rate (tpr) (machine learning) using an analogy.
If you are unaware of a sensitive attribute, it is like you are wearing a blindfold. You cannot see anything in front of you, no matter how close or how far away it is.	unawareness (to a sensitive attribute)	Explain unawareness (to a sensitive attribute) (machine learning) using an analogy.
Undersampling is like when you are at a party and there are too many people and you can't talk to everyone so you have to choose who to talk to. You might choose to talk to the people who are standing in the corner or the people who are by themselves. You are not talking to everyone, but you are talking to the people who are the most interesting to you.	undersampling	Explain undersampling (machine learning) using an analogy.
Unidirectional learning is like a computer that can only learn from data that is provided to it in a specific direction. For example, a computer might be able to learn how to identify objects in pictures, but it would not be able to learn how to identify objects in pictures if it was only given pictures of objects from one perspective.	unidirectional	Explain unidirectional (machine learning) using an analogy.
A unidirectional language model is a machine learning model that is used to predict the next word in a sequence of words. It is similar to a predictive text keyboard, which predicts the next word based on the previous word.	unidirectional language model	Explain unidirectional language model (machine learning) using an analogy.
If you were to learn a new language, you might be given a list of words with no translations. Over time, you would learn what each word means by seeing it used in different contexts. The unlabeled example in machine learning is similar to this. The machine learning algorithm is given a set of data (e.g. pictures of animals) without any labels or descriptions. It then tries to learn how to identify different animals by looking at the features of the pictures.	unlabeled example	Explain unlabeled example (machine learning) using an analogy.
Unsupervised machine learning is like a toddler learning how to speak. The toddler is not given any instructions on how to speak, but instead is allowed to explore the world and learn from experience. The toddler will eventually learn how to speak by observing and imitating the people around them.Unsupervised machine learning is a process of learning how to perform a task by observing data without any prior instruction on the task. The machine learning algorithm is given a set of data, and it is then left to figure out how to best group or categorize that data.	unsupervised machine learning	Explain unsupervised machine learning (machine learning) using an analogy.
Upweighting is a technique used in machine learning to improve the accuracy of predictions. It is similar to boosting, but it is applied after the learning algorithm has been trained. Upweighting is used to give more importance to the most accurate examples, so that the learning algorithm can learn from them more effectively.	upweighting	Explain upweighting (machine learning) using an analogy.
A user matrix is a table that shows how often different users interact with each other on a social media platform. It can be used to help determine which users are the most influential on the platform.	user matrix	Explain user matrix (machine learning) using an analogy.
Validation is like a teacher checking homework. The teacher checks to make sure the student has done the work correctly and that the student understands the work.	validation	Explain validation (machine learning) using an analogy.
The vanishing gradient problem is a problem that can occur in machine learning when trying to learn a deep neural network. It occurs when the gradient of the error function (the slope of the line that shows how the error changes as we change the network's parameters) becomes very small as we go deeper into the network. This can cause the network to learn very slowly or not at all.	vanishing gradient problem	Explain vanishing gradient problem (machine learning) using an analogy.
Wasserstein loss is a machine learning technique that is used to improve the accuracy of predictions made by a machine learning algorithm. It is similar to the technique of cross-validation, in that it helps to ensure that the predictions made by the machine learning algorithm are accurate. However, unlike cross-validation, wasserstein loss does not require that the data be divided into separate training and testing sets. Instead, it uses a technique called kernel smoothing to improve the accuracy of predictions.	wasserstein loss	Explain wasserstein loss (machine learning) using an analogy.
Weight is a measure of how much an object resists being moved. In the same way, weight in machine learning is a measure of how much an object resists being moved by a machine learning algorithm.	weight	Explain weight (machine learning) using an analogy.
Weighted alternating least squares is a machine learning algorithm that is used to optimize a model. It is similar to the gradient descent algorithm, but it takes into account the weights of the data points. This allows the algorithm to focus on the most important data points and improve the accuracy of the model.	weighted alternating least squares (wals)	Explain weighted alternating least squares (wals) (machine learning) using an analogy.
A wide model is like a big net that catches a lot of fish. It is good at generalizing from a lot of data.	wide model	Explain wide model (machine learning) using an analogy.
Width is the distance between two points. In machine learning, it is the distance between the prediction of a model and the actual value.	width	Explain width (machine learning) using an analogy.
Embedding is a technique used in machine learning for representing text data in a low-dimensional space. This is done so that similar items are closer together in the space, and can be more easily identified and clustered. Embedding can be thought of as a way of mapping words to a coordinate system, where each word is represented by a point in the space.	word embedding	Explain word embedding (machine learning) using an analogy.
