NADH is like a battery. It helps power the cell's activities.	nadh	Explain NADH using an analogy
NADH is like a battery in a car. It provides energy for the car to run.	nadh	Explain NADH using an analogy
NADH can be thought of as a rechargeable battery. It is used to power the cell and help it run smoothly. When NADH levels are low, the cells may not work as well as they should.	nadh	Explain NADH using an analogy
NADH is a bit like batteries in a flashlight. The NADH "batteries" store energy that can be used to power the lightbulb.	nadh	Explain NADH using an analogy
NAD+ can be thought of as an empty bank account, and NADH can be thought of as money deposited into that account. The more NADH there is in the account, the more energy the cell has available to do work.	nadh	Explain NADH using an analogy
Proteins are like the workers in a factory. They build and maintain the structures inside of cells.	proteins	Explain proteins using an analogy
Proteins are like the workers in a factory. They do all of the hard work to keep everything running smoothly.	proteins	Explain proteins using an analogy
A protein is like a jigsaw puzzle. The pieces (amino acids) fit together to form a complete picture.	proteins	Explain proteins using an analogy
A protein is like a string of Christmas lights. The individual bulbs are the amino acids, and the string itself is the protein. Just as you can plug different-colored lightbulbs into a string of Christmas lights, you can mix and match different amino acids to create different proteins.	proteins	Explain proteins using an analogy
A protein is like a library. The library has many different books, and each book is filled with letters. Just as the letters in a book can be put together to form words and sentences, the amino acids in a protein can be linked together to form a chain.	proteins	Explain proteins using an analogy
How about this analogy: DNA is like a recipe for a cake. The recipe is written down on a piece of paper, and it tells you everything that you need to put into the cake in order to make it. The ingredients are listed, as well as the amounts that you need to use. The same thing is true for DNA - it contains all of the information that's needed to create a living organism.	dna	Explain DNA using an analogy
If you think of the DNA molecule as a book, then each "letter" in the DNA sequence is like a word. The order of these letters (words) determines what type of protein is made. Just like how different combinations of letters can create different words with different meanings, the different combinations of DNA letters can create proteins with different functions.	dna	Explain DNA using an analogy
DNA is like a library. Each book in the library is like a gene. The books are all arranged on shelves according to their topic.	dna	Explain DNA using an analogy
DNA is like a set of instructions for making a person. It is like a recipe that tells your body how to grow and develop.	dna	Explain DNA using an analogy
DNA is like a set of blueprints for a house. The blueprint tells the builder what materials to use and how to put them together to create the house. DNA tells the cells in our body what proteins to make and how to put them together.	dna	Explain DNA using an analogy
Glycogen is a bit like a collection of tiny spoons. Just as each spoon can hold a small amount of food, each strand of glycogen can store a small amount of glucose. When we need energy, our bodies break down the glycogen into glucose molecules and use them for fuel.	glycogen	Explain Glycogen using an analogy
Glycogen is a lot like the gas in your car. It's stored energy that can be used when you need it.	glycogen	Explain Glycogen using an analogy
Glycogen is a lot like the gas in your car. It's what makes the engine go. Glycogen is stored in your muscles and it's what gets burned to create energy for you to move.	glycogen	Explain Glycogen using an analogy
Glycogen is like a savings account for the body. It's a way for the body to store energy so that it can be used when needed.	glycogen	Explain Glycogen using an analogy
Glycogen is the storage form of glucose in animals. Glucose is like gasoline for a car. The glycogen analogy would be like having a bunch of gas cans in the trunk of your car.	glycogen	Explain Glycogen using an analogy
Endoplasmic reticulum can be thought of as a complex network of tubes and chambers that crisscross throughout the cytoplasm of a cell. This organelle is responsible for producing, processing, and transporting proteins and lipids. It can be thought of as a kind of internal factory inside the cell.	endoplasmic reticulum	Explain Endoplasmic reticulum using an analogy
Endoplasmic reticulum is a lot like the plumbing in your house. It's a system of tubes and pipes that carries water (or other fluids) around. The endoplasmic reticulum in your cells carries proteins and other important molecules around.	endoplasmic reticulum	Explain Endoplasmic reticulum using an analogy
Endoplasmic reticulum is like a big factory inside the cell. It processes and manufactures proteins that are needed by the cell.	endoplasmic reticulum	Explain Endoplasmic reticulum using an analogy
Endoplasmic reticulum is a lot like the roads and highways in your town. The roads are used to get around, and the highway system helps traffic move quickly between different parts of town. The endoplasmic reticulum is used to move things around in the cell, and the Golgi apparatus helps traffic move quickly between different parts of the cell.	endoplasmic reticulum	Explain Endoplasmic reticulum using an analogy
Endoplasmic Reticulum can be thought of as the transportation system within a cell. The ER is responsible for moving proteins and other materials around the cell. It can be thought of as a network of tubes that run throughout the cytoplasm.	endoplasmic reticulum	Explain Endoplasmic reticulum using an analogy
A Golgi apparatus is like a post office. It takes letters (ribosomes) from one part of the cell and ships them off to other parts of the cell (the endoplasmic reticulum).	golgi	Explain Golgi using an analogy
Golgi is like a post office. The cells send packages (products of protein synthesis) to Golgi, where they are sorted and then sent off to their destinations (either the cell surface or another organelle).	golgi	Explain Golgi using an analogy
Golgi is like a post office. The mail comes in from all over the country, and it's sorted and sent out from there.	golgi	Explain Golgi using an analogy
Golgi is like a shipping and receiving department for the cell. It sorts and packages proteins that are made in the ribosomes and sends them to their final destinations inside or outside of the cell.	golgi	Explain Golgi using an analogy
Golgi is a bit like the postal service. It takes all of the different packages that have been sent from different parts of the cell (the nucleus, mitochondria, endoplasmic reticulum) and sorts them into neat little bundles that can be sent off to their final destinations.	golgi	Explain Golgi using an analogy
If you think of the plasma membrane as a bouncer at a club, then the proteins embedded in it would be like the bouncer's muscles. The bouncer can use his muscles to stop anyone he doesn't want from entering the club, and the proteins in the plasma membrane can use their shapes to stop anything they don't want from entering or leaving the cell.	plasma membrane	Explain Plasma membrane using an analogy
The plasma membrane is like a fence. It is used to keep things in or out. The cells are on one side of the fence and the outside world is on the other side.	plasma membrane	Explain Plasma membrane using an analogy
A plasma membrane can be thought of as a fence. The cells are on one side of the fence and everything else is on the other side. The fence protects the cells from things on the other side while also allowing things like oxygen and water to pass through.	plasma membrane	Explain Plasma membrane using an analogy
Plasma membrane can be compared to the walls of a house. The plasma membrane is selectively permeable, meaning that it allows some things to pass through while keeping other things out. Just like the walls of a house keep people and animals in, while letting air and light in, the plasma membrane keeps certain molecules inside of cells while allowing others to flow freely across it.	plasma membrane	Explain Plasma membrane using an analogy
A plasma membrane can be thought of as a bouncer at a club. The bouncer is responsible for deciding who gets in and who doesn't. The plasma membrane allows certain things to pass through it, while keeping other things out.	plasma membrane	Explain Plasma membrane using an analogy
Lysosomes are like the garbage disposal of a cell. They digest and break down old, damaged or unused parts of the cell.	lysosome	Explain Lysosome using an analogy
Lysosomes are like trash cans inside of cells. The cell can put things in the lysosome that it wants to get rid of, and then the lysosome will break them down so they can be used again.	lysosome	Explain Lysosome using an analogy
Lysosomes are like the stomachs of cells. They digest things that the cell needs to use, like old proteins.	lysosome	Explain Lysosome using an analogy
A lysosome is a bit like a recycling bin. It's a small organelle in the cell that breaks down old or damaged proteins and other molecules. This helps to keep the cell healthy and functioning properly.	lysosome	Explain Lysosome using an analogy
Lysosomes are like the recycling bins of a city. They take in materials that can be reused, break them down into smaller pieces, and then release those pieces back into the environment where they can be used again.	lysosome	Explain Lysosome using an analogy
If you think of the cell as a city, then the nucleus would be the downtown area where all of the important buildings are located. The mitochondria would be like the suburbs – they’re not quite in the city center, but they’re still close by. Peroxisomes, on the other hand, would be like rural areas – they’re far from downtown and most people wouldn’t even know they exist.Peroxisomes are small organelles that play an important role in metabolism. They help cells break down proteins and other molecules into smaller pieces. This process is known as catabolism, and it helps to provide energy for the cell. Peroxisomes also produce hydrogen peroxide, which can kill bacteria and viruses.	peroxisomes	Explain Peroxisomes using an analogy
Peroxisomes are like a recycling center for the cell. They take in old, damaged molecules and break them down into their component parts. These parts can then be reused to build new, healthy molecules.	peroxisomes	Explain Peroxisomes using an analogy
Peroxisomes are like the recycling centers of a city. They take in garbage (waste products) and recycle them into new materials that can be used by the cells.	peroxisomes	Explain Peroxisomes using an analogy
If you think of the cell as a city, then peroxisomes would be the recycling plants. They recycle old materials (cellular waste) into new ones so that the city can continue to function properly.	peroxisomes	Explain Peroxisomes using an analogy
Peroxisomes can be thought of as the "recycling centers" of the cell. Just like in a city, where people recycle bottles and cans to help reduce waste, peroxisomes recycle cellular materials that would otherwise be wasted. They do this by breaking down large molecules into smaller ones that can then be used by the cell again.	peroxisomes	Explain Peroxisomes using an analogy
Mitochondria can be thought of as the powerhouses of the cell. Just like a car needs gasoline to run, cells need energy in order to function. Mitochondria produce this energy by breaking down food molecules into useable energy called adenosine triphosphate (ATP).	mitochondria	Explain Mitochondria using an analogy
Mitochondria can be thought of as the "powerhouses" of cells. Just like a power plant supplies energy to a city, mitochondria supply energy to cells. They produce adenosine triphosphate (ATP), which is used by cells for many purposes, including powering movement and synthesizing proteins.	mitochondria	Explain Mitochondria using an analogy
Mitochondria can be thought of as the powerhouse of the cell. Just like a power plant provides electricity for an entire city, mitochondria provide energy for the cells in our bodies.	mitochondria	Explain Mitochondria using an analogy
Mitochondria can be thought of as the "power plants" of the cell. They are responsible for producing energy in the form of ATP (adenosine triphosphate) for the cell to use.	mitochondria	Explain Mitochondria using an analogy
Mitochondria can be thought of as the "powerhouses" of the cell. Just like a power plant provides energy to run a city, mitochondria provide energy to run cells. Mitochondria produce adenosine triphosphate (ATP), which is used by cells for many purposes, such as building proteins and replicating DNA.	mitochondria	Explain Mitochondria using an analogy
Chloroplasts are like the solar panels of a plant. They convert energy from the sun into chemical energy that can be used by plants to create glucose from carbon dioxide and water.	chloroplast	Explain Chloroplast using an analogy
Chloroplasts are like the solar panels of a plant. They use sunlight to convert carbon dioxide and water into glucose and oxygen gas.	chloroplast	Explain Chloroplast using an analogy
Chloroplasts are like the batteries in a car. They store energy that can be used to power the plant’s activities.	chloroplast	Explain Chloroplast using an analogy
Chloroplasts are a bit like solar panels. They use the energy from the sun to turn carbon dioxide and water into glucose and oxygen.	chloroplast	Explain Chloroplast using an analogy
Chloroplasts are like the lungs of a plant. They take in carbon dioxide from the air and turn it into sugar.	chloroplast	Explain Chloroplast using an analogy
The cytoskeleton is like the scaffolding of a building. It helps to support the shape and organization of the cell, as well as providing a framework for intracellular movement.	cytoskeleton	Explain cytoskeleton using an analogy
The cytoskeleton is like a scaffold inside of the cell. The scaffold helps to hold up the cell and its contents.	cytoskeleton	Explain cytoskeleton using an analogy
The cytoskeleton is like the skeleton of a person. It provides support and structure to the cell.	cytoskeleton	Explain cytoskeleton using an analogy
The cytoskeleton is like a scaffold that helps to support the cell. It is made up of proteins that help to keep the cell shape and also allow it to move around.	cytoskeleton	Explain cytoskeleton using an analogy
The cytoskeleton of a cell can be thought of as the scaffolding that supports and organizes the cell's contents. Just as a construction worker uses scaffolding to support the weight of materials while they are being assembled, so too does the cytoskeleton support and organize the proteins and other molecules within the cell. Additionally, just as workers can use scaffolding to move around materials on a construction site, so too do cells use their cytoskeletons to move things around inside themselves.	cytoskeleton	Explain cytoskeleton using an analogy
ATP is like the gasoline in a car. It provides the energy for the engine to run.	atp	Explain ATP using an analogy
ATP can be thought of as the currency of energy in the body. Just like money is needed to buy things, ATP is necessary for cells to do work. Cells use ATP to power all sorts of activities, including muscle movement and cell division.	atp	Explain ATP using an analogy
ATP is like the gasoline in a car. It provides the energy for the car to move.	atp	Explain ATP using an analogy
ATP can be thought of as the currency of life. Just like money is needed to purchase goods and services, ATP is necessary for cells to carry out all their functions. Cells produce ATP through a process called cellular respiration, which breaks down glucose (sugar) into smaller molecules that release energy. This energy is used to power everything from cell growth and replication to muscle movement.	atp	Explain ATP using an analogy
ATP is like money in the bank. It's a resource that can be used to do work.	atp	Explain ATP using an analogy
NADPH can be thought of as the body's "fuel tank." It is a molecule that is used to produce energy in the cells. Just like gasoline powers a car, NADPH provides energy for the body's cells.	nadph	Explain NADPH using an analogy
NADPH is like a rechargeable battery. It can be used over and over again to help produce energy in the body.	nadph	Explain NADPH using an analogy
NADPH is like a battery that stores energy. The battery can be used to power things like lights or motors. NADPH also helps to produce new cells in the body.	nadph	Explain NADPH using an analogy
NADPH is like a battery in a car. It helps to power the engine (the mitochondria) so that the car can run.	nadph	Explain NADPH using an analogy
NADPH is a type of fuel that helps the cells in our bodies work. It's kind of like gasoline for a car - it helps the engine run smoothly and makes sure everything works the way it's supposed to.	nadph	Explain NADPH using an analogy
The peroxysome is a bit like a recycling plant for the cell. It recycles old or damaged proteins, fats and other molecules by breaking them down into their component parts. These parts can then be reused to make new proteins, fats and molecules.	peroxysome	Explain PEROXYSOME using an analogy
A peroxysome is a tiny sac filled with hydrogen peroxide, similar to how an ice pack is filled with water. When the skin is injured, the body releases enzymes that break down the ice pack and release the cold water. In a similar way, when a cell is damaged, it releases enzymes that break down the peroxysomes and release hydrogen peroxide.	peroxysome	Explain PEROXYSOME using an analogy
A peroxysome is like a tiny oxygen factory inside of cells. It takes in oxygen and glucose, and makes energy for the cell.	peroxysome	Explain PEROXYSOME using an analogy
Peroxysomes are like the recycling plant for a city. They take all of the old, broken down materials and recycle them into new materials to be used again.	peroxysome	Explain PEROXYSOME using an analogy
A peroxysome is like a tiny factory inside of each cell that produces hydrogen peroxide. This chemical can kill bacteria, and so it helps to protect the body against infection.	peroxysome	Explain PEROXYSOME using an analogy
Mytochondria is a lot like the engine in your car. It provides the energy that makes the car move. Mytochondria produce ATP, which is used by all of the cells in your body to do work.	mytochondria	Explain MYTOCHONDRIA using an analogy
Myochondria can be thought of as the "powerhouses" of a cell. Just like a car needs gasoline to run, cells need myochondria to produce energy. Myochondria are analogous to the gas tank, engine, and other parts that make a car run. Without myochondria, cells would not be able to function properly.	mytochondria	Explain MYTOCHONDRIA using an analogy
Myochondria can be seen as the "heart" of a muscle cell. Just like the heart is responsible for pumping blood throughout the body, myochondria are responsible for supplying energy (in the form of ATP) to all parts of the cell. Without myochondria, muscles would not be able to function properly.	mytochondria	Explain MYTOCHONDRIA using an analogy
Myochondria are the powerhouses of the cell. They can be thought of as batteries, providing energy to allow the cell to function.	mytochondria	Explain MYTOCHONDRIA using an analogy
MYTOCHONDRIA are like the batteries in a car. They store energy and provide power to the rest of the car.	mytochondria	Explain MYTOCHONDRIA using an analogy
Electricity is like water. Water can flow through pipes, and electricity can flow through wires. Just as you need a faucet to control the water, you need a switch to control the electricity.	electric forces	Explain Electric forces using an analogy
Electric forces can be thought of as like people trying to push each other around in a crowd. The more people that are pushing on one person, the harder it is for them to move. Electric forces work in the same way. The more electric charges that are pushing on one another, the harder it is for them to move.	electric forces	Explain Electric forces using an analogy
Electric forces can be thought of as being similar to magnets. Just as two magnets will attract or repel each other, so too do electric charges. The force between two objects is directly proportional to the product of their charges and inversely proportional to the square of the distance between them.	electric forces	Explain Electric forces using an analogy
Electric forces can be thought of as being like magnets. Just as two magnets will attract or repel each other, similarly electric charges will either attract or repel one another.	electric forces	Explain Electric forces using an analogy
Electric forces are like magnets. Magnets have two poles, a north pole and a south pole. If you bring two magnets close to each other, the north poles will repel each other and the south poles will attract each other. Electric charges work in the same way. They also have two poles, an electric North Pole and an electric South Pole. If you bring two charged objects close to each other, the electric North Poles will repel each other and the electric South Poles will attract each other	electric forces	Explain Electric forces using an analogy
An electron's orbital can be thought of as a race car driving around a track. The track is circular and the race car always drives around it in the same direction. The size of the track is like the size of the orbital, and the direction that the racecar is traveling in is like the direction that the electron is orbiting.	hydrogen electron's orbital	Explain hydrogen electron's orbital using an analogy
An analogy for hydrogen electron orbitals would be planets orbiting around the sun. The sun is analogous to the nucleus, and the planets are analogous to the electrons. The planets' orbits are determined by their distance from the sun, just as an electron's orbital is determined by its distance from the nucleus.	hydrogen electron's orbital	Explain hydrogen electron's orbital using an analogy
The orbit of a hydrogen electron is like the path of a planet around the sun. The electron's orbit is not a perfect circle, but it follows an elliptical path that takes it closer to and farther from the nucleus.	hydrogen electron's orbital	Explain hydrogen electron's orbital using an analogy
Imagine you have a bunch of balloons. One balloon has a string attached to it and the other balloons are free to move around. The balloon with the string is like an electron in an orbital, while the other balloons are like hydrogen atoms. If you move the balloon with the string around, it will stay close to where it is connected. But if you move one of the other balloons around, it will fly away from where it was originally located.	hydrogen electron's orbital	Explain hydrogen electron's orbital using an analogy
One way to think about hydrogen electron orbitals is to imagine them as the paths that electrons take around a race track. Just like there are many different types of race tracks, there are many different types of hydrogen electron orbitals. Some orbitals go around in circles, some go around in squares, and others go around in zigzags. The shape of each orbital depends on how much energy an electron has.	hydrogen electron's orbital	Explain hydrogen electron's orbital using an analogy
Lines of defense in the body can be thought of as similar to fortifications in a castle. The first line of defense is the outer wall, followed by the inner wall and finally the keep (or stronghold). Each layer serves as a barrier against invaders, with each one becoming increasingly more difficult to penetrate. Similarly, in the body, each layer of defense is responsible for preventing pathogens from entering and causing infection. The skin is the first barrier, followed by mucous membranes, innate immunity and adaptive immunity.	first line of defense in the body	Explain first line of defense in the body using an analogy
The body's first line of defense is like a big wall that stands between the bad things outside and the good things inside. The wall has lots of gates that can be opened to let the good things in, but it also has gates that can be closed to keep the bad things out.	first line of defense in the body	Explain first line of defense in the body using an analogy
The first line of defense in the body is like a fortress with walls and gates. The walls are made up of skin, mucous membranes, and hair, while the gates are made up of tears, saliva, and stomach acid. These barriers protect the body from harmful invaders like bacteria and viruses.	first line of defense in the body	Explain first line of defense in the body using an analogy
The first line of defense in the body is like a bouncer at a club. They are there to check IDs and make sure that people who are not allowed into the club are not able to get in. In the same way, the first line of defense in the body is responsible for keeping out bacteria, viruses, and other things that can make us sick.	first line of defense in the body	Explain first line of defense in the body using an analogy
The first line of defense in the body is similar to a castle with a moat. The moat is filled with water and it surrounds the castle. If an intruder tries to get into the castle, they will have to swim through the water and this will slow them down or stop them from getting into the castle. The same thing happens in our bodies when we are attacked by bacteria or viruses. Our skin is like the moat and it acts as a barrier between us and the bacteria or virus. Our skin traps the bacteria or virus and it cannot get past our skin into our bodies.	first line of defense in the body	Explain first line of defense in the body using an analogy
A macrophage is like a vacuum cleaner. It sucks up all the dirt and debris in its path.	macrophages	Explain macrophages using an analogy
Macrophages are like the police force of your body. They patrol around and keep an eye out for anything that looks suspicious or dangerous. If they see something that needs to be dealt with, they will take action and get rid of it.	macrophages	Explain macrophages using an analogy
A macrophage is like a police officer. They patrol the body and look for anything that doesn't belong. If they find something, they will get rid of it.	macrophages	Explain macrophages using an analogy
If macrophages are likened to the police, then they would be the officers who patrol the streets and respond to calls for help. They are responsible for keeping order and fighting crime. Macrophages also work to clean up any messes or damage that has been done, similar to how a police officer would investigate a crime scene and mop up any spilled blood.	macrophages	Explain macrophages using an analogy
A macrophage is a bit like a vacuum cleaner. It's job is to suck up any debris or bacteria that might be in the area. Macrophages also help to activate the immune system and recruit other cells to fight off infection.	macrophages	Explain macrophages using an analogy
A T-helper cell is a bit like a coach. It helps other cells in the body to do their job properly.	t-helper cells	Explain T-helper cells using an analogy
A T-helper cell is like a personal assistant. They help to organize and carry out the instructions of other cells in the immune system.	t-helper cells	Explain T-helper cells using an analogy
A T-helper cell is like a personal assistant to a police officer. The T-helper cell helps the police officer by providing information about the crime, giving them guidance on what to do next, and helping to keep them organized.	t-helper cells	Explain T-helper cells using an analogy
A T-helper cell is like a construction worker. They help to build up the immune system and destroy any harmful invaders.	t-helper cells	Explain T-helper cells using an analogy
A T-helper cell can be thought of as the quarterback on a football team. They are responsible for calling the plays and organizing the other players on the field. In terms of immunity, they direct the activities of other cells to help fight off infection.	t-helper cells	Explain T-helper cells using an analogy
B-lymphocytes are like bouncers at a nightclub. They keep out the bad guys (viruses, bacteria) and let in the good guys (other cells).	b-lymphocytes	Explain B-lymphocytes using an analogy
A B-lymphocyte is like a bouncer at a nightclub. They are responsible for determining who gets in and who doesn't.	b-lymphocytes	Explain B-lymphocytes using an analogy
Think of B-lymphocytes as the body's security guards. They patrol the bloodstream and lymph nodes, looking for signs of infection or disease. When they find something suspicious, they sound the alarm and call in other cells to help fight the infection.	b-lymphocytes	Explain B-lymphocytes using an analogy
B-lymphocytes are like generals in an army. They lead the other cells in the immune system and direct them to fight off infections.	b-lymphocytes	Explain B-lymphocytes using an analogy
B-lymphocytes are like soldiers in the immune system. They recognize and remember specific bacteria, viruses, or other invaders. When they see the same invader again, they can quickly produce antibodies to attack it.	b-lymphocytes	Explain B-lymphocytes using an analogy
Think of cytotoxic T-lymphocytes as "Pac-Man" cells. These cells patrol the body, looking for cancer cells to eat up. Once they find a cancer cell, they gobble it up and destroy it.	cytotoxic t-lymphocytes	Explain Cytotoxic T-lymphocytes using an analogy
Cytotoxic T-lymphocytes are like a team of secret agents. They sneak around inside the body, looking for cells that are not supposed to be there. Once they find one, they kill it!	cytotoxic t-lymphocytes	Explain Cytotoxic T-lymphocytes using an analogy
Cytotoxic T-lymphocytes can be thought of as the "police" of the immune system. They are responsible for identifying and destroying cells that are infected or have been damaged, such as cancer cells.	cytotoxic t-lymphocytes	Explain Cytotoxic T-lymphocytes using an analogy
A cytotoxic T-lymphocyte is like a sheriff in town. The sheriff is always on the lookout for criminals and will arrest them when he finds them. Cytotoxic T-lymphocytes are also always looking for viruses or cancer cells and will kill them when they find them.	cytotoxic t-lymphocytes	Explain Cytotoxic T-lymphocytes using an analogy
Cytotoxic T-lymphocytes are like the police of the immune system. They patrol the body and identify cells that are not supposed to be there, such as cancer cells or bacteria. Once they identify a cell as being harmful, they destroy it.	cytotoxic t-lymphocytes	Explain Cytotoxic T-lymphocytes using an analogy
An analogy for how bacteria invade cells would be to imagine a group of people trying to break into a building. The people are the bacteria and the building is the cell. The door is the cell membrane and the windows are the pores in it. The people can only get in if they find a way to open or break through the door or windows.	invasion of bacterias	Explain invasion of bacterias using an analogy
One way to think of the invasion of bacteria is as an "invasion" of your home by a foreign army. Just like an actual invading army, the bacteria come into your home through some opening (in this analogy, your mouth or nose), and begin taking over the space, spreading throughout your body and causing damage along the way.	invasion of bacterias	Explain invasion of bacterias using an analogy
If you think of your body as a house, bacteria are like tiny little bugs that can invade through the tiniest crack in the window. Once they're inside, they can start multiplying and cause all sorts of problems.	invasion of bacterias	Explain invasion of bacterias using an analogy
Invasion of bacterias can be likened to an army invading a country. The bacteria are like the soldiers, and they invade the cells in the body to cause infection.	invasion of bacterias	Explain invasion of bacterias using an analogy
Invasion of bacteria is similar to an army invading a country. The bacteria are like the soldiers and they invade the cells in the body, which are like the people of the country. Once inside, the bacteria can cause damage to the cells and make them sick.	invasion of bacterias	Explain invasion of bacterias using an analogy
The best way to think about the action potential is to imagine it as a wave of electricity that passes through the neuron. This wave can be thought of as being similar to a tsunami, except it moves much faster. The action potential begins when an electrical current flows into the neuron at one end. This current causes sodium ions to flow into the neuron, which creates a positive charge inside the cell. This positive charge attracts potassium ions out of the cell, and this starts a new current that travels down the length of the neuron. As this new current passes through each segment of the neuron, it causes more sodium ions to flow in and more potassium ions to flow out, creating another wave of electricity that quickly spreads throughout the entire neuron.	action potential	Explain action potential using an analogy
Action potentials are a bit like pressure waves moving through water. Imagine you have a pipe full of water and you suddenly start poking it with your finger. The pressure at the point of your finger will be very high, but as the wave moves away from the finger, the pressure will decrease. This is similar to what happens with an action potential - the point where it's generated has a lot of voltage (pressure), but as it travels down the nerve fibre (pipe), the voltage decreases	action potential	Explain action potential using an analogy
Action potentials are like waves in the ocean. Just as a wave can move up and down the length of the ocean, an action potential can travel along a neuron.	action potential	Explain action potential using an analogy
Action potentials can be thought of as waves that spread through a crowd at a large event. The wave starts with one person pushing its way to the front, and then quickly spreads to everyone else in the area. This is similar to what happens with an action potential – it starts with the neuron sending a signal down its axon, and then quickly spreads to other neurons.	action potential	Explain action potential using an analogy
Action potential is a lot like what happens when you turn on a light switch. When you flip the switch, electricity flows through the wires and turns on the light. The same thing happens with your nerves. When an electrical signal travels down a nerve, it causes special proteins to open up and let sodium ions flood into the neuron. This creates an action potential that travels all the way down the nerve until it reaches the end.	action potential	Explain action potential using an analogy
 Chromatography is like a large office building with many different departments. The offices are all separated by walls, and each department has its own unique function. If you want to go to the accounting department, you have to know which door to go through and then walk down the hallway until you find the right office.	experiment of chromatography	Explain experiment of chromatography using an analogy
If you have ever tried to separate the colors of a rainbow using a piece of paper, you have performed a type of chromatography. In this experiment, you put some water droplets on the paper, then add some ink. The different colors in the ink will spread out through the water droplets as they soak into the paper. As each color moves at a different speed, it will end up in a different spot on the paper. This is because each color is made up of tiny particles that travel at different speeds when wet.	experiment of chromatography	Explain experiment of chromatography using an analogy
Chromatography is a bit like making a cake. You have all of the ingredients - flour, sugar, eggs, butter, baking powder - and you mix them together to make a batter. But if you want a really good cake, you need to use quality ingredients. So instead of just using any old flour, you might use wheat flour or even better - whole grain flour. The same goes for sugar, eggs and butter. By using the best ingredients, you'll get a better cake.The same is true for chromatography. You have all of the chemicals that make up your sample (the batter), but by using different types of chromatography paper (flour), you can get a better picture of what's in your sample (the cake).	experiment of chromatography	Explain experiment of chromatography using an analogy
Lets say you have a plate of food with different colors of sauce on it. You want to figure out which color is which, so you use a toothpick to take a little bit of each sauce and put it on a separate piece of paper. Then you fold the pieces of paper in half and put them all next to each other. By looking at the folded-over papers, you can easily see which color is on each one by the stain that's left behind. This is kind of like what happens when you do chromatography - you're separating out the different colors (or molecules) in whatever substance you're testing by putting it on a piece of paper and then folding the paper in half so that the different colors are separated.	experiment of chromatography	Explain experiment of chromatography using an analogy
Imagine you have a plate of spaghetti and meatballs. The spaghetti is the 'sample' that you are testing, and the meatballs are the 'components' of the sample. You want to know how much salt is in each meatball, so you divide them up into small groups and test one group at a time. This is like doing chromatography - you are testing a small part of the sample at a time to see which components are present.	experiment of chromatography	Explain experiment of chromatography using an analogy
A star's life is like a human lifespan. A newborn baby is small and weak, but they grow bigger and stronger as they age. In the same way, a young star is small and faint, but it grows bigger and brighter as it ages. The main-sequence lifetime of a star is how long it spends growing big and bright, just like a human on the main sequence of their life.	main-sequence lifetimes of stars	Explain main-sequence lifetimes of stars using an analogy
A star's main-sequence lifetime is about 10 billion years. This can be thought of as the length of time a typical human will live on Earth. Just as people have different lifespans, stars also have different lifetimes depending on their size and composition.	main-sequence lifetimes of stars	Explain main-sequence lifetimes of stars using an analogy
The main-sequence lifetime of a star is like the lifespan of a human. The average human lifespan is around 75 years, but there are some people who live to be 100 and others who die at the age of 5. This is because different humans have different life expectancies, just as different stars have different main-sequence lifetimes.	main-sequence lifetimes of stars	Explain main-sequence lifetimes of stars using an analogy
A star's main-sequence lifetime is about 10 billion years. This means that a star will spend about 90% of its life on the main sequence. An analogy for this would be human beings. We are born, we grow up and live most of our lives in the prime of our lives and then we eventually die.	main-sequence lifetimes of stars	Explain main-sequence lifetimes of stars using an analogy
The main sequence lifetime of a star is much like the lifespan of a person. The bigger and hotter the star, the shorter its life on the main sequence. A small, cool star might live for 10 billion years on the main sequence, while a huge, hot star might only last for 1 million years.	main-sequence lifetimes of stars	Explain main-sequence lifetimes of stars using an analogy
Nucleus is like a city. The nucleus is the center of the atom and contains most of the atoms mass. The city has streets, houses, and buildings. The nucleus has protons and neutrons which are like the people in the city. Electrons are like cars driving around on the streets.	nucleus	Explain nucleus using an analogy
Nucleus is like the brain of a cell. It controls all the important functions of the cell and coordinates activities with other cells.	nucleus	Explain nucleus using an analogy
A nucleus is like a city. It is the center of activity and has many residents (protons and neutrons). The city has a mayor (the nucleus) and it oversees all the activities that occur there.	nucleus	Explain nucleus using an analogy
Nucleus is like the brain of a cell. It directs what goes on in the cell and controls its activities.	nucleus	Explain nucleus using an analogy
Nucleus is like the brain of a cell. It controls everything that goes on in the cell and it also contains all of the genetic information for the cell.	nucleus	Explain nucleus using an analogy
Ribosomes are like the machines that make the products in a factory. The DNA is like the blueprint for making the product and the ribosomes are like the machines that follow the blueprint to create the product.	ribosomes	Explain Ribosomes using an analogy
Ribosomes are like the machines that put together the pieces of a car. The blueprints for the car are in the factory, and the ribosomes put together all of the parts according to those plans.	ribosomes	Explain Ribosomes using an analogy
Ribosomes can be thought of as the cell's protein factories. Just like a real factory, ribosomes need raw materials to produce products. The raw materials for ribosomes are called "amino acids." These amino acids are delivered to the ribosome by another organelle in the cell called the "endoplasmic reticulum."	ribosomes	Explain Ribosomes using an analogy
Ribosomes are like construction workers. They build the proteins that our cells need to survive.	ribosomes	Explain Ribosomes using an analogy
Ribosomes are like the machines in a factory. The DNA is like the design for the product and the ribosomes are what put it all together.	ribosomes	Explain Ribosomes using an analogy
The Golgi apparatus is like a post office. It receives packages from different places and sorts them out before sending them to their final destination.	golgi apparatus	Explain Golgi Apparatus using an analogy
The Golgi apparatus is a lot like the post office. The Golgi receives packages (molecules) from all over the cell, and sorts them into different mailboxes (compartments). Then, it sends the mail (molecules) to their correct destinations.	golgi apparatus	Explain Golgi Apparatus using an analogy
The Golgi Apparatus is like a post office. The parcels (packages) arrive at the post office and are sorted into different mailboxes according to their destination address. The Golgi Apparatus does a similar job, sorting proteins into different parts of the cell according to their function.	golgi apparatus	Explain Golgi Apparatus using an analogy
The Golgi apparatus is a bit like a post office. It receives packages (the proteins that are made by the ribosomes) from all over the cell and sorts them into different mailboxes according to their addresses. Then it sends these packages off to their destinations inside the cell.	golgi apparatus	Explain Golgi Apparatus using an analogy
The Golgi Apparatus is like a post office. The post office receives letters (packages of proteins) from all over the country and organizes them into bundles that are sent to specific destinations. The Golgi Apparatus does the same thing with proteins that come from different parts of the cell. It sorts them into packages that are sent to specific destinations inside the cell.	golgi apparatus	Explain Golgi Apparatus using an analogy
Lysosomes are like tiny garbage cans inside of cells. They eat up old or damaged parts of the cell, and recycle them into new materials that the cell can use.	lysosomes	Explain Lysosomes using an analogy
Lysosomes are like the stomachs of cells. They digest food and break down waste products so that the cell can use them for energy or dispose of them.	lysosomes	Explain Lysosomes using an analogy
Lysosomes are like a recycling center in your cells. They recycle old or damaged cells parts by breaking them down into small pieces.	lysosomes	Explain Lysosomes using an analogy
Lysosomes are like the garbage disposal in your kitchen. They take in old, damaged cells and break them down into their component parts so that the cells can be reused.	lysosomes	Explain Lysosomes using an analogy
Lysosomes are like the garbage cans of cells. They are filled with enzymes that break down proteins, lipids, and other materials in the cell. This allows the lysosomes to recycle these materials and use them again.	lysosomes	Explain Lysosomes using an analogy
The nuclear envelope is like a coat of armor that surrounds and protects the nucleus. It is made up of two membranes, the inner membrane and the outer membrane. The inner membrane forms a kind of "wall" around the nucleus, while the outer membrane wraps around the inner membrane.	nuclear envelope	Explain Nuclear Envelope using an analogy
The nuclear envelope is like a balloon that surrounds the nucleus of a cell. It helps to protect the DNA inside the nucleus and it also helps to control what goes in and out of the nucleus.	nuclear envelope	Explain Nuclear Envelope using an analogy
The nuclear envelope is like a bouncer at a nightclub. It is responsible for controlling what goes in and out of the nucleus, much like how a bouncer controls who gets into the club and who doesn't.	nuclear envelope	Explain Nuclear Envelope using an analogy
The nuclear envelope is like a coat that wraps around the nucleus of a cell. It helps to protect the nucleus from damage and also controls what goes in and out of the nucleus.	nuclear envelope	Explain Nuclear Envelope using an analogy
Nuclear envelope can be thought of as a bouncer at a nightclub. It is responsible for controlling access to the nucleus, and only allows certain things (like proteins) inside.	nuclear envelope	Explain Nuclear Envelope using an analogy
A vacuole is like a balloon. It is filled with fluid and it has a thin wall.	vacuoles	Explain Vacuoles using an analogy
A vacuole is like a balloon. It can fill up with things, like water or air, and it can change size depending on how much stuff is inside of it.	vacuoles	Explain Vacuoles using an analogy
If you imagine the cell as a city, then the nucleus would be the downtown area where all the important buildings are located. The cytoplasm would be like the suburbs - it's mostly residential with a few businesses here and there. And finally, vacuoles would be like rural areas - they're mostly farmland with a few small villages sprinkled throughout.	vacuoles	Explain Vacuoles using an analogy
Think of a vacuum as a container with a hole in the bottom. Stuff that doesn't belong in the container falls out through the hole. The same thing happens with vacuoles in plant cells - they act as containers for waste products and other stuff that needs to be eliminated from the cell.	vacuoles	Explain Vacuoles using an analogy
A vacuole is like a balloon. It is filled with air and it makes the balloon round.	vacuoles	Explain Vacuoles using an analogy
The cytoplasm is like the soup in a can of Campbell's Soup. It is the liquid that holds all of the ingredients together.	cytoplasm	Explain Cytoplasm using an analogy
Cytoplasm is like a soup. It contains the cells' nutrients and organelles.	cytoplasm	Explain Cytoplasm using an analogy
The cytoplasm can be thought of as a cell's "internal ocean." It is where most of the chemical reactions that keep the cell alive take place, and it contains all of the cellular organelles except for the nucleus. Just like an ocean is filled with water, the cytoplasm is filled with a liquid called cytosol. This cytosol contains dissolved proteins, salts, and other molecules that are necessary for life.	cytoplasm	Explain Cytoplasm using an analogy
The cytoplasm of a cell is like the white blood cells in our body. They are both filled with fluid and they help to protect us from infection. The cytoplasm surrounds the nucleus of the cell and it contains all of the organelles that make the cell work.	cytoplasm	Explain Cytoplasm using an analogy
If the cell is a city, then the nucleus would be the mayor and the cytoplasm would be the citizens. The nucleus controls what goes on in the city (the cell), while the cytoplasm carries out all of the day-to-day activities.	cytoplasm	Explain Cytoplasm using an analogy
A chromosome is like a library book. It has all the information needed to create and run a cell.	chromosome	Explain Chromosome using an analogy
A chromosome is like a book. It has many different chapters that are all related to each other.	chromosome	Explain Chromosome using an analogy
If chromosomes were people, they would be the long-distance runners of the cell. They are very important for organizing and controlling everything that goes on in the cell.	chromosome	Explain Chromosome using an analogy
Chromosomes are like the books in a library. Each book has its own place on the shelf and can be easily found when you need it. The same is true for chromosomes - they have their own specific location within the cell and can easily be identified.	chromosome	Explain Chromosome using an analogy
Chromosomes are like books. Each chromosome has a lot of information in it, just like each book has a lot of information in it. The amount of information that is in each chromosome and book is about the same.	chromosome	Explain Chromosome using an analogy
The cytosol is like a city. The nucleus is the mayor, and the chromosomes are the buildings. The proteins are the people who live in the city, and the DNA is like the street map.	cytosol	Explain Cytosol using an analogy
The cytosol is like a city. The cells are the buildings and the cytosol is the streets and sidewalks that connect them together. The proteins are like the people who live in the cells and do their work.	cytosol	Explain Cytosol using an analogy
A cytosol analogy could be a city. The nucleus would be the downtown area, where all the important buildings are. The mitochondria would be the suburbs, and they provide energy to the city. The cells themselves would be the streets and sidewalks, and everything else inside of them (including the cytosol) would be the buildings.	cytosol	Explain Cytosol using an analogy
The cytosol is like a city. The cells are like the buildings and the cytosol is like the streets that connect them. The proteins are like the cars driving on the streets and the DNA is like the driver of each car.	cytosol	Explain Cytosol using an analogy
Cytosol is like the soup inside a can of Campbell's chicken noodle soup. It's mostly water, but it also has small pieces of vegetables and chicken in it. The cytosol contains all of the cellular machinery that allows the cell to function.	cytosol	Explain Cytosol using an analogy
A cell is like a small city. It has workers, managers, and resources. The workers are the cells that do the work of the city. The managers are the genes that make sure everything runs smoothly. The resources are things like food and water that keep the city running.	cell	Explain cell using an analogy
A cell is like a tiny city. It has all the components of a city including workers, homes, and a governing body. The cells workers are called proteins and they do the work of the cell. The home for the proteins is called the ribosome and the governing body is called the nucleus.	cell	Explain cell using an analogy
A cell is like a small city. It has workers, buildings, and a way to get things in and out.	cell	Explain cell using an analogy
A cell is like a small city. It has workers, managers, and resources. The workers are the cells that do the work of the city. The managers are the cells that control the work of the city. The resources are what the city needs to survive.	cell	Explain cell using an analogy
A cell is like a room in a house. The room has walls, a ceiling, and a floor. It also has furniture, such as a bed and dresser. In the same way, cells have membranes that act as walls, ceilings, and floors. They also have organelles, which are like the furniture in the room.	cell	Explain cell using an analogy
A vesicle is like a tiny bag that floats around in the cytoplasm of a cell. The cytoplasm is the jelly-like substance inside the cells.	vesicles	Explain vesicles using an analogy
A vesicle is like a small balloon. It is filled with a liquid or gas and has a thin membrane that separates the inside from the outside.	vesicles	Explain vesicles using an analogy
The analogy that is often used to explain vesicles is that they are like soap bubbles. Just as a bubble forms when soap film wraps around air, a vesicle forms when the cell membrane wraps around its contents.	vesicles	Explain vesicles using an analogy
A vesicle is like a small balloon. It is filled with a liquid or gas and has a thin membrane that separates it from the surrounding area.	vesicles	Explain vesicles using an analogy
Bubbles are a good analogy for vesicles. Bubbles form when gas is trapped in liquid, and they grow until the pressure of the gas inside exceeds the atmospheric pressure. Vesicles form in a similar way: A small amount of fluid containing dissolved molecules collects in a bubble-shaped cavity that enlarges as more fluid diffuses into it.	vesicles	Explain vesicles using an analogy
A cell wall is a bit like the walls of a house. They hold the cells together and keep things inside. The cell wall also helps to protect the cells from things outside, like bacteria and viruses.	cell wall	Explain cell wall using an analogy
A cell wall is like a castle wall. It protects the inside of the castle from being invaded, and it also helps strengthen the castle.	cell wall	Explain cell wall using an analogy
A cell wall can be thought of as the equivalent of a castle wall. Just as a castle wall protects the people and things inside the castle, the cell wall protects everything inside the cell. The cell wall is made up of a tough outer layer called the plasma membrane and a strong inner layer called the cytoskeleton	cell wall	Explain cell wall using an analogy
Cell walls are like the bricks in a wall. They hold the cells together and give them their shape.	cell wall	Explain cell wall using an analogy
A cell wall is like a protective fence around a city. It helps to keep things out (like bacteria) and it also helps to keep things in (like water).	cell wall	Explain cell wall using an analogy
A cell is like a small city. It has workers, managers, and resources. The workers are the cells that do the work of the city. The managers are the cells that control and organize the work of the city. The resources are what keep the city running, such as food, water, and energy.	cells	Explain cells using an analogy
Cells can be thought of as the basic building blocks of life. Just as bricks are used to build a house, cells are used to build tissues and organs. Like a house needs a strong foundation, tissues and organs need healthy cells in order to function properly.	cells	Explain cells using an analogy
Cells are like tiny factories. They take in raw materials, process them, and create something new.	cells	Explain cells using an analogy
A cell can be compared to a small city. The cell has workers, managers, a mayor, and citizens. The workers are the proteins that do the work of the cell. The managers are the enzymes that control what happens in the cells. The mayor is the DNA that directs what goes on in the cell. The citizens are the molecules that carry out the instructions from the DNA.	cells	Explain cells using an analogy
Cells are the basic building blocks of life. Just like a city is made up of many different buildings, cells are made up of many different molecules. Cells come in all shapes and sizes - just like cities do.	cells	Explain cells using an analogy
A cell membrane is sort of like a bouncer at a club. He checks IDs to make sure everyone is allowed in, and he makes sure that the people inside the club are following the rules. The cell membrane does something similar for cells. It keeps things like nutrients and oxygen from flowing freely in and out, while making sure waste products can leave the cell.	cell membrane	Explain Cell Membrane using an analogy
The cell membrane is like a border patrol. It stands guard around the cells and only lets in things that are good for the cell. The membrane is also responsible for getting rid of waste products from the inside of the cell.	cell membrane	Explain Cell Membrane using an analogy
The cell membrane can be thought of as a barrier that separates the inside of a cell from its environment. This barrier is selectively permeable, meaning that it allows some substances to pass through while blocking others. The cell membrane is made up of a lipid bilayer, which is composed of two layers of fatty acids molecules. These fatty acids form a tight seal that helps to protect the cell from its surroundings.	cell membrane	Explain Cell Membrane using an analogy
The cell membrane is like a castle wall. It protects the cells inside and keeps things out.	cell membrane	Explain Cell Membrane using an analogy
A cell membrane can be thought of as a brick wall. The bricks are the cells and the mortar is the cell membrane. The thickness of the wall depends on how many bricks are used. In the same way, the thickness of a cell membrane depends on how many cells are stacked together.	cell membrane	Explain Cell Membrane using an analogy
A golgi body is like a postal service. The postal service receives packages from all over the world, sorts them by country, and delivers them to the correct addresses. The golgi body receives proteins from all over the cell, sorts them by type, and sends them to the correct destinations.	golgi body	Explain Golgi body using an analogy
Golgi bodies are like the post office for cells. They process and package proteins that are made in the cell's cytoplasm. These proteins are then sent to other parts of the cell, or even to other cells, where they will be used.	golgi body	Explain Golgi body using an analogy
Golgi body is like a postal worker. It takes the packages (ribosomes) from the shipping room (mitochondria) and delivers them to the correct addresses (endoplasmic reticulum).	golgi body	Explain Golgi body using an analogy
A Golgi body is like a post office. The mail arrives at the post office and is sorted by the workers there. Then, it is sent to the correct address. In the same way, proteins arrive at the Golgi body and are sorted by the workers there. Then, they are sent to the correct destination inside of the cell.	golgi body	Explain Golgi body using an analogy
The Golgi body is like a post office. It receives packages (membrane proteins) from all over the cell and sorts them into different mailboxes (cisternae).	golgi body	Explain Golgi body using an analogy
CAPACITANCE can be thought of as the electrical equivalent of a container that can hold a certain amount of water. Just like with water, the more capacitance there is, the more charge it can store.	capacitance	Explain CAPACITANCE using an analogy
A capacitor is a bit like a container of water. If you have two containers of water, one with a small hole in the bottom and one with a large hole in the bottom, which container will fill up first? The container with the small hole in the bottom, because it has less capacitance.	capacitance	Explain CAPACITANCE using an analogy
CAPACITANCE is a lot like a bucket of water. Just as the more water you have in the bucket, the more weight it has, capacitance is increased by adding electrons to the capacitor. The greater the capacitance, the more weight it takes to move those electrons.	capacitance	Explain CAPACITANCE using an analogy
CAPACITANCE is similar to a water tank. Just like the more water you have in the tank, the higher the pressure will be at the bottom, CAPACITANCE creates a voltage difference between two points based on how much charge is stored.	capacitance	Explain CAPACITANCE using an analogy
A capacitor is like a container of water. The more water you have in the container, the higher the capacitance will be.	capacitance	Explain CAPACITANCE using an analogy
Electric current is like a river of electricity. The water in the analogy represents electrons, and the width of the river (or current) represents how many electrons are moving past a certain point each second. Just as rivers can have different speeds depending on how much water is flowing and what kind of terrain it's flowing over, electric currents can also have different speeds depending on how many electrons are moving and what kind of material they're flowing through.	electric current	Explain electric current using an analogy
Electric current is like a river of electrons flowing through a wire. Just as a river flows downhill, the electric current flows from high to low potential (voltage). The higher the voltage, the faster the electrons will flow.	electric current	Explain electric current using an analogy
Electric current can be thought of as water flowing through a hose. Just as the water flows more quickly through a narrow hose, electric current flows more quickly through a thin wire.	electric current	Explain electric current using an analogy
Electric current is like a river of electricity flowing through a wire.	electric current	Explain electric current using an analogy
Electric current is like water flowing through a pipe. Just as the amount of water flow can be controlled by adjusting the size of the opening in the pipe (the diameter of the pipe), the amount of electric current can be controlled by adjusting the size of the opening in the electrical circuit (the cross-sectional area of wire).	electric current	Explain electric current using an analogy
Voltage is like water pressure. Just as the higher water pressure in a hose can push more water through it, a higher voltage can push more electric current through a wire.	voltage	Explain Voltage using an analogy
A voltage is like a water pressure. Just as water can flow through a pipe at different speeds depending on the pressure (the higher the pressure, the faster the water flows), electricity can flow through a wire at different speeds depending on the voltage (the higher the voltage, the faster the electricity flows).	voltage	Explain Voltage using an analogy
Voltage is like the pressure of water in a hose. It is the force that makes the water move. Voltage is measured in volts.	voltage	Explain Voltage using an analogy
Volts can be thought of as the water pressure in a hose. Just like with water, more volts means more pressure (and power).	voltage	Explain Voltage using an analogy
Voltage is like water pressure. Just as water can flow through a pipe due to the pressure of the water behind it, electricity can flow through a wire due to the voltage (or electrical pressure) applied to it.	voltage	Explain Voltage using an analogy
One way to think of the specialization and communication within cells is to imagine a group of people who are all working together on one big project. Each person has a different role and specialty within the project, but they all communicate with each other to make sure that everything is moving forward as planned. The same thing happens inside cells – different parts of the cell have specialized functions, but they all work together to keep the cell running smoothly.	specialization and communication in a cell	Explain specialization and communication in a cell using an analogy
A cell is like a city. The cells in our body are specialized to do different tasks, just like the people in a city have different jobs. Some cells communicate with each other using hormones, just like people in a city use phones and email to communicate.	specialization and communication in a cell	Explain specialization and communication in a cell using an analogy
In a cell, specialization is like having different parts of the body perform different functions. For example, your heart performs a specific function (pumping blood), and your brain performs a specific function (thinking). Communication in a cell is like communication between different parts of the body. Your heart sends signals to your brain telling it to pump more blood, and your brain sends signals to your muscles telling them to move.	specialization and communication in a cell	Explain specialization and communication in a cell using an analogy
A cell is like a small city. The cell has many different parts that need to communicate with each other in order for the cell to function properly. The brain is the mayor of the city and sends orders to the different parts of the cell. The part of the cell that receives these orders is called the receptor. The receptor interprets the message from the brain and sends instructions to the rest of the cells.	specialization and communication in a cell	Explain specialization and communication in a cell using an analogy
A cell is like a small city. The cells in our bodies are specialized to do different things, just like the people in a city have different jobs. Some cells specialize in getting energy from food and turning it into useful molecules for the body, some specialize in fighting infection, and others help us think and move. Cells communicate with each other by sending chemical signals called hormones.	specialization and communication in a cell	Explain specialization and communication in a cell using an analogy
Kirchoff's Voltage Law states that the sum of all voltages in a loop must be zero. This law can be explained using an analogy of water flow in a pipe. The water pressure at any point in the pipe is the sum of the pressures from all the other points upstream. In the same way, the voltage at any point in a circuit is equal to the sum of all voltages from all other points in the circuit.	kirchoff's voltage law	Explain Kirchoff's Voltage Law using an analogy
If you have a long, straight piece of wire and you hold one end up in the air and touch the other end to the ground, electricity will flow through the wire. You can think of this as water flowing through a pipe. The higher your hand is holding the end of the wire, the more pressure there is on the water (or electricity). The lower your hand is holding the end of the wire, the less pressure there is on the water (or electricity). This analogy works because voltage is just like pressure.	kirchoff's voltage law	Explain Kirchoff's Voltage Law using an analogy
Kirchoff's Voltage Law is similar to the law of gravity. Just as masses attract one another in a gravitational field, charges within an electric field are attracted to each other. Like masses, the strength of the force between two charges decreases as the distance between them increases.	kirchoff's voltage law	Explain Kirchoff's Voltage Law using an analogy
Kirchoff's voltage law is a bit like traffic laws. Just as drivers need to obey the speed limit and stop at red lights, electric current needs to obey the voltage limit and flow in only one direction. Violating either of these rules can cause accidents (or electrical fires, in the case of electricity).	kirchoff's voltage law	Explain Kirchoff's Voltage Law using an analogy
Kirchoff's Voltage Law is similar to the way water behaves in a plumbing system. Just as water always flows downhill, electricity will always flow from high voltage to low voltage. This law is also known as Kirchhoff's Current Law.	kirchoff's voltage law	Explain Kirchoff's Voltage Law using an analogy
A density wave is like a group of people walking in a line. The people are all close together at the start of the line, but they spread out as they walk.	nature of a density wave	Explain nature of a density wave using an analogy
A density wave can be thought of as a crowd of people that are moving through a hallway. The people in the front of the crowd are moving quickly, while the people in the back are moving more slowly.	nature of a density wave	Explain nature of a density wave using an analogy
A density wave is like a group of people walking in a line. The people are close together at the beginning and end of the line, but there is more space between them in the middle.	nature of a density wave	Explain nature of a density wave using an analogy
A density wave is a bit like a group of people walking together in an orderly fashion. The people are close together at the start of the wave, but gradually spread out as they walk. In the same way, a density wave starts off with all the particles closely packed together, but they gradually spread out as the wave moves along.	nature of a density wave	Explain nature of a density wave using an analogy
A density wave is a bit like a traffic jam on a highway. The cars are all in the same place and aren't moving very fast.	nature of a density wave	Explain nature of a density wave using an analogy
Enzymes are like tiny machines that help the chemical reaction in our body run smoothly. Just as machines need oil to keep them running smoothly, enzymes need a special molecule called coenzyme to work properly.	enzymes	Explain enzymes using an analogy
Enzymes are like tiny machines that help to speed up chemical reactions in the body. They are like worker ants, gathering and carrying pieces of food to the larger workers who chop it up into smaller pieces.	enzymes	Explain enzymes using an analogy
If you think of enzymes as tiny robots, then they are the workers that build and repair everything in your body. Enzymes help to digest food, fight infection, and keep you healthy.	enzymes	Explain enzymes using an analogy
Enzymes are like tiny machines that help chemical reactions happen in the body. They're sort of like keys that fit into locks and turn them, making it possible for other chemicals to join together and do their job.	enzymes	Explain enzymes using an analogy
Enzymes are like scissors. They cut things apart.	enzymes	Explain enzymes using an analogy
The human active memory system can be likened to a computer's random access memory (RAM). The RAM stores the information that is currently being used by the computer. The active memory similarly stores the information that is currently being used by the person. When new information needs to be remembered, it is first stored in the active memory. If necessary, the active memory can then be transferred to long-term storage, such as the person's brain.	human active memory system	Explain human active memory system using an analogy
Human active memory can be compared to a computer's RAM. Just as RAM temporarily stores data that is currently in use by the computer, human active memory stores information that is currently being used by the brain. The contents of RAM are constantly changing as the computer processes new information, and the contents of human active memory are also constantly changing as the brain takes in new information.	human active memory system	Explain human active memory system using an analogy
The human active memory system can be thought of as a library. The library has many different shelves, each with its own section. Each section is filled with books on a specific topic. When you need to remember something, you can go to the library and find the book that covers that topic. You then take the book home with you and read it so that the information is stored in your memory.	human active memory system	Explain human active memory system using an analogy
The human active memory system can be likened to a computer's random access memory (RAM). Just as RAM provides a temporary space for programs and data to be accessed by a computer, active memory allows information to be stored and retrieved quickly and easily in the human brain. In both cases, the faster the RAM or active memory can access information, the more efficient the system will be.	human active memory system	Explain human active memory system using an analogy
The human active memory system is like a computer. The computer has a hard drive which stores all of the information that it has ever received, and a random access memory (RAM) which stores the information that it is currently using. The RAM is like our short-term memory - it holds the information for a short period of time before it is either forgotten or transferred to the hard drive.	human active memory system	Explain human active memory system using an analogy
The rate-determining step of a reaction is like the slowest person in a race. They determine the speed of the entire race.	rate-determining step of a reaction	Explain rate-determining step of a reaction using an analogy
The rate-determining step of a reaction is the slowest step in the overall process. This analogy can help to explain it: imagine you are walking down a flight of stairs. The speed at which you can descend the stairs depends on how fast you can walk and how fast each individual step is. If you take small, quick steps, you'll be able to move quickly down the stairs. However, if one of your steps is particularly large or difficult, it will slow your descent significantly. In the same way, the rate-determining step determines the speed of a chemical reaction - it's the part that limits how quickly things happen.	rate-determining step of a reaction	Explain rate-determining step of a reaction using an analogy
The rate-determining step of a reaction is like the slowest runner in a race. The other runners can keep going as fast as they want, but the race won't be won until the slowest runner crosses the finish line. In a chemical reaction, the rate-determining step is the step that happens most slowly.	rate-determining step of a reaction	Explain rate-determining step of a reaction using an analogy
The rate-determining step of a reaction is the slowest step in the overall process. This analogy might help to explain it: imagine you are trying to get from point A to point B, but there are several obstacles in your way. The obstacle that takes the longest time to overcome is the rate-determining step.	rate-determining step of a reaction	Explain rate-determining step of a reaction using an analogy
The rate-determining step is the slowest step in a reaction. This analogy might help to explain it: imagine you are walking up a hill. The speed at which you can walk up the hill is determined by the slowest part of the journey, which is usually going uphill. In the same way, the rate of a chemical reaction is determined by the slowest step in that reaction.	rate-determining step of a reaction	Explain rate-determining step of a reaction using an analogy
Column chromatography is like a grocery store. You have different types of food (purity levels) on different shelves. The customer can go down the aisle and look at each product to see what they want.	column chromatography	Explain column chromatography using an analogy
Column chromatography is like a large kitchen where the cook can use many different spices to flavor a dish. The cook can put all of the spices in one bowl and mix them together, or she can put each spice in its own bowl and add them to the dish one at a time. Column chromatography is similar to using the individual bowls because it lets you control how much of each compound you add to your sample.	column chromatography	Explain column chromatography using an analogy
Column chromatography is like a funnel. The solvent starts at the top of the column and moves through to the bottom, where it is collected. The solid material is packed into the column, and as the solvent moves through it, the solutes are separated based on their different levels of attraction to the solvent and to each other.	column chromatography	Explain column chromatography using an analogy
Column chromatography is similar to a clothes dryer. The column is like the dryer and the sample is like the clothes. The solvent travels up the column (like hot air in a dryer) and pulls the molecules of interest with it (like how hot air dries clothes). At the top of the column, these molecules are collected (like when your clothes come out of the dryer).	column chromatography	Explain column chromatography using an analogy
Column chromatography is like a grocery store, where the products are arranged in aisles. The different products (chromatographic bands) are separated by their size and weight, just as they would be on supermarket shelves.	column chromatography	Explain column chromatography using an analogy
A simple way to think of dynamic chemical equilibrium is as a balance between opposing forces. In the same way that pushing on one side of a scale will make it tip in that direction, but eventually the weight of everything on the other side will push it back to where it started, similarly chemicals in a solution are constantly reacting and exchanging partners until they reach equilibrium. At equilibrium, there is no net change in concentration or pH even though the reactions are still happening.	dynamic chemical equilibrium	Explain Dynamic Chemical Equilibrium using an analogy
Dynamic chemical equilibrium can be best explained by using an analogy. When two people are pushing a car, one person is doing all of the work while the other person is just holding on. The first person is like the forward reaction and the second person is like the reverse reaction. As long as both people are pushing equally hard, then the car will stay in motion. If one person stops pushing, then the other person will start to do all of the work and eventually get tired. This is like dynamic chemical equilibrium where as long as both reactions are happening at equal rates, then nothing will change. But if something happens to upset this balance (like a catalyst), then one reaction will start to happen faster than the other and you will see a change in concentration over time	dynamic chemical equilibrium	Explain Dynamic Chemical Equilibrium using an analogy
Dynamic chemical equilibrium can be thought of as a tug-of-war match in which both teams are equally strong. In this analogy, the two teams represent the reactants and products of a chemical reaction. The rope in the middle of the field represents the Chemical Equilibrium. As long as both teams are pulling with equal force, the rope will stay in place. However, if one team begins to pull harder than the other, the rope will move in that direction.	dynamic chemical equilibrium	Explain Dynamic Chemical Equilibrium using an analogy
Dynamic chemical equilibrium is a bit like a see-saw. One side (the reactants) is up, and the other side (the products) is down. The reactants are always trying to go back to their original position (the bottom of the see-saw), and the products are always trying to go back to their original position (the top of the see-saw). But because there's a weight on both sides, it never quite happens.	dynamic chemical equilibrium	Explain Dynamic Chemical Equilibrium using an analogy
A dynamic chemical equilibrium is like a group of people in a room who are all talking to each other. The more people who talk, the more noise there is. But as time goes on, some people get tired and stop talking, while others start up. So the level of noise in the room varies over time, but eventually it reaches a steady state where the same amount of people are talking at any given moment.	dynamic chemical equilibrium	Explain Dynamic Chemical Equilibrium using an analogy
A vacuole can be thought of as a container that ships goods from one side of the world to another. The goods are placed in the vacuole and it is sealed shut. The vacuole then travels across the ocean until it reaches its destination. Once it arrives, the vacuole opens and releases the goods inside.	vacuole	Explain VACUOLE using an analogy
A vacuole can be thought of as a balloon. The balloon is filled with air and it has a thin skin. The skin holds the air in the balloon.	vacuole	Explain VACUOLE using an analogy
A vacuole is a bit like a balloon. It is a small, round structure that fills with fluid. This fluid can be used to store food or water, or it can be used to get rid of waste products.	vacuole	Explain VACUOLE using an analogy
A vacuole is like a balloon. It can inflate and deflate to change its size.	vacuole	Explain VACUOLE using an analogy
A VACUOLE can be thought of as a balloon. As the balloon is filled with air, it becomes round and inflated. The VACUOLE fills with water, which makes it round and inflated.	vacuole	Explain VACUOLE using an analogy
A transport vesicle is like a bus. The cell membrane is the curb and the cytoskeleton are the streets. Small molecules and ions are like passengers on the bus, while larger proteins or organelles are like luggage.	transport vesicles	Explain TRANSPORT VESICLES using an analogy
A transport vesicle is like a bus. It can carry many people (molecules) from one place to another very quickly.	transport vesicles	Explain TRANSPORT VESICLES using an analogy
A transport vesicle is like a bus. The cell's proteins are the passengers and the membrane of the vesicle is the bus itself. The cytoskeleton provides the road for the bus (vesicle) to travel on.	transport vesicles	Explain TRANSPORT VESICLES using an analogy
A transport vesicle is a lot like a bus. The nucleus is the bus station, and the chromosomes are the passengers. The transport vesicles carry the chromosome passengers to their new destinations within the cell.	transport vesicles	Explain TRANSPORT VESICLES using an analogy
A transport vesicle is like a bus. The cells that need to send something somewhere get on the bus (the transport vesicle) and take it to where they want to go.	transport vesicles	Explain TRANSPORT VESICLES using an analogy
A proto-oncogene is like a regular gene, but it has the potential to cause cancer if it's mutated. Just like how a car can be used for good or bad, a proto-oncogene can either help fight against cancer or contribute to its development.	proto-oncogenes	Explain proto-oncogenes using an analogy
In cancer, proto-oncogenes are like brakes on a car. They keep the cells from growing and dividing too quickly. When these genes mutate, they become oncogenes and the brake is released. The cells can now grow and divide without limits, leading to cancer.	proto-oncogenes	Explain proto-oncogenes using an analogy
.A proto-oncogene is like a regular gene, except that it has the potential to cause cancer. Just as a car can be used for good (e.g., driving to work) or bad (e.g., using it to run someone over), a proto-oncogene can be used for good (e.g., helping cells grow and divide normally) or bad (causing cells to grow and divide out of control, leading to cancer).	proto-oncogenes	Explain proto-oncogenes using an analogy
Proto-oncogenes are like the spark plugs in a car. They start the engine and make it run. Cancer is like when the car doesn't stop running and keeps going even after you take your foot off the pedal. The proto-oncogenes have been turned on permanently and they're making the cancer cells keep growing and dividing.	proto-oncogenes	Explain proto-oncogenes using an analogy
Proto-oncogenes are like the ignition switch for a car. They turn on cancer growth, but they can also be turned off by tumor suppressor genes.	proto-oncogenes	Explain proto-oncogenes using an analogy
One way to think of oncogenes is as cancer-causing genes. They are like pieces of a jigsaw puzzle that, when put together, can cause normal cells to become cancerous. Normally, these genes are kept under control by tumor suppressor genes. But if something happens to disrupt the balance between these two types of genes, then oncogenes can start causing tumors.	oncogenes	Explain Oncogenes using an analogy
If we think of oncogenes as being like a virus, they are similar to the HIV virus. Just as the HIV virus can infect healthy cells and turn them into factories that produce more viruses, oncogenes can cause normal cells to become cancerous by making them divide uncontrollably.	oncogenes	Explain Oncogenes using an analogy
Oncogenes are like a weed in the garden. They are genes that have been turned on, or "switched on." Normally these genes are silent, but something, such as radiation or a chemical carcinogen, can turn them on. Once they are turned on, they can cause normal cells to become cancerous.	oncogenes	Explain Oncogenes using an analogy
A oncogene is like a super-charged gene that can cause cancer. It's like a car with the nitrous oxide system turned up to high. The gas pedal is stuck and the car races out of control, smashing into everything in its way.	oncogenes	Explain Oncogenes using an analogy
Oncogenes are like a cancerous tumor. They are genes that have been mutated and can cause cells to grow and divide uncontrollably, which can lead to cancer.	oncogenes	Explain Oncogenes using an analogy
Tumor suppressor genes are like the body's security guards. They keep an eye on the cells and make sure they don't turn into tumors. If a tumor starts to form, the tumor suppressor gene will step in and stop it.	tumor suppressor genes	Explain Tumor suppressor genes using an analogy
A tumor suppressor gene is a bit like a car's airbag. It's not essential for the car to work, but it helps keep you safe in case of an accident. Tumor suppressor genes help protect cells from becoming cancerous, and they also help stop tumors from growing.	tumor suppressor genes	Explain Tumor suppressor genes using an analogy
Tumor suppressor genes are like the brakes on a car. They help to keep the cells in check and stop them from growing out of control.	tumor suppressor genes	Explain Tumor suppressor genes using an analogy
One analogy for tumor suppressor genes is that they are like the brakes on a car. They help to slow down or stop cell growth when it gets out of control.	tumor suppressor genes	Explain Tumor suppressor genes using an analogy
Suppose you have a car with a faulty brake system. The car can still drive, but it's not safe. If the brake system is left unchecked, the car will eventually crash. Tumor suppressor genes are like the brake system in our analogy. They help to keep cancer cells from growing and dividing out of control.	tumor suppressor genes	Explain Tumor suppressor genes using an analogy
Brittle software is like a house of cards. It's easy to knock it down and very hard to rebuild.	brittle software	Explain Brittle Software using an analogy
One way to think about brittle software is to imagine it as a piece of glass. A sturdy, well-made piece of glass can be used for many purposes and will last for a long time. However, a thin piece of glass that is not carefully made can easily break if it is handled incorrectly or dropped on the ground. Brittle software is like the thin piece of glass – it does not stand up well to stress or use, and it breaks easily.	brittle software	Explain Brittle Software using an analogy
Brittle software is like a brittle glass window. It's very fragile and can easily break when it's hit or when pressure is applied.	brittle software	Explain Brittle Software using an analogy
If you think of software as a physical object, it can be brittle in the same way that glass is. Glass is strong and durable when it's used for things like windows or bottles, but if it's mishandled or dropped it can easily break into pieces. Software can be fragile in a similar way – if it's not handled carefully or updated regularly, it can easily become corrupted or unusable.	brittle software	Explain Brittle Software using an analogy
Brittle software is like a piece of glass that can easily break into pieces. It doesn't take much for it to shatter and once it's broken, it's very difficult to put back together again.	brittle software	Explain Brittle Software using an analogy
A resonance hybrid is like an octopus. It has a lot of arms (like the different orbitals on the atoms) and each arm can hold something different (like the electrons in the atom). The octopus can stretch its arms out to grab things (like electrons), but it also has a strong body that holds everything together (like the nucleus).	resonance hybrid	Explain resonance hybrid using an analogy
An analogy for resonance hybrid is a group of people standing on a trampoline. The people are like the atoms in a molecule and the trampoline is like the electrons. When one person jumps, it causes the other people to jump too. This is because they are all connected. In the same way, when one atom in a molecule jumps to a higher energy level, it causes the other atoms in the molecule to jump too.	resonance hybrid	Explain resonance hybrid using an analogy
A resonance hybrid is a model of the real molecule that uses Lewis structures to show how electrons are distributed. It's like a Venn diagram, where each circle represents one of the possible Lewis structures for the molecule. The overlapping circles represent the electrons that are shared between those structures.	resonance hybrid	Explain resonance hybrid using an analogy
One way to think of resonance is to imagine a large rock concert where the sound waves created by the musicians are bouncing off the walls and ceiling of the venue. Some of these sound waves will be in sync with each other, while others will be out of sync. In order to create the most intense sound, you need as many sound waves as possible that are in sync with each other. This is what happens when molecules resonate - they create a more intense signal by allowing multiple waves to build on top of each other.	resonance hybrid	Explain resonance hybrid using an analogy
If you have ever played with a Slinky®, you know that when it is stretched out and then released, it bounces back and forth between its original position and the ground. This happens because the kinetic energy of the Slinky® is passed from one section to the next until it hits the ground. In a similar way, resonance occurs in molecules when they exchange energy among their component parts.	resonance hybrid	Explain resonance hybrid using an analogy
The wave mechanical model is similar to a group of people running in a line. Each person represents a particle and the distance between each person is the wavelength. The waves are created by the movement of the particles and when two waves collide, they create an interference pattern.	wave mechanical model	Explain wave mechanical model using an analogy
A wave mechanical model is similar to a Slinky toy. When you pull one end of the Slinky, the other end moves too. The waves move down the Slinky and cause it to stretch. In physics, this is called a transverse wave.	wave mechanical model	Explain wave mechanical model using an analogy
A wave model is like a group of people walking in a line. Each person takes two steps forward and one step back. This happens over and over again so the people are always moving forward even though they are taking small steps backward occasionally.	wave mechanical model	Explain wave mechanical model using an analogy
A wave mechanical model can be thought of as a crowd of people walking across a bridge. The people represent the atoms in a molecule, and the bridge represents the bond between them. When someone walks across the bridge, they create waves that spread outwards until they reach the edge. The same thing happens with molecules; when an atom moves, it creates waves that spread out until they reach the edge of the molecule.	wave mechanical model	Explain wave mechanical model using an analogy
A wave mechanical model is like a group of people playing catch. The ball (representing the molecule) is thrown back and forth between the players (representing the atoms). As the ball moves, it creates waves that travel out from where it was originally thrown.	wave mechanical model	Explain wave mechanical model using an analogy
An analogy for an electroencephalogram (EEG) would be to think of it as a type of sonar. Just as sonar emits sound waves and then listens for the echoes that bounce back off objects in order to create a map of what is around it, EEGs emit electrical waves and listen for the echoes that bounce back off objects in order to create a map of what is happening inside someone's brain.	electroencephalogram	Explain Electroencephalogram using an analogy
It is a bit like when your car's engine light comes on. The electroencephalogram (EEG) machine is reading the electrical activity of your brain just like a mechanic would read the code on your dashboard to find out what is wrong with your car.	electroencephalogram	Explain Electroencephalogram using an analogy
To understand an electroencephalogram (EEG), imagine your brain is a computer. The EEG is like the computer's built-in monitor that shows you what's going on inside the machine. It records and displays the electrical activity of your brain in real time.	electroencephalogram	Explain Electroencephalogram using an analogy
The brain is like a computer and the EEG is like the screen on the computer. The EEG measures the electric activity in your brain. This means it can tell what kind of thoughts or activities you are thinking about or doing.	electroencephalogram	Explain Electroencephalogram using an analogy
A doctor may use an electroencephalogram (EEG) to measure the electrical activity of a person's brain. This test is like taking the pulse of someone's brain. Just as doctors can tell a lot about a person's health by taking their pulse, they can learn about a person's brain health by looking at the electrical activity in their brain.	electroencephalogram	Explain Electroencephalogram using an analogy
When you make a copy of a document, the photocopier uses light to create an image of the text on a piece of paper. This image is then transferred to another piece of paper using heat and pressure. DNA replication works in a similar way. The genetic information on one strand of DNA is used as a template to create a new strand of DNA	dna replication	Explain DNA replication using an analogy
DNA replication is similar to a photocopier. The DNA molecule is like the original document, and the copies are like the photocopies.	dna replication	Explain DNA replication using an analogy
Replication of DNA is like making a copy of a book. The first step is to get the original book and make two copies of it. Next, cut each copy in half so you have four books. Take one of the halves and cut it in half again so you have eight books. Finally, take one of the eight books and cut it into fourths so you have 32 books. You now have an exact replica of the original book.	dna replication	Explain DNA replication using an analogy
Replication of DNA is a bit like making a photocopy of a document. The original document is the template for the copy and the copy looks exactly like the original.	dna replication	Explain DNA replication using an analogy
DNA replication is a bit like making an exact copy of a document. The DNA molecule is like the original document, and each strand of DNA is like one half of the copy. During replication, enzymes called polymerases read the DNA sequence and create two new strands that are identical to the original.	dna replication	Explain DNA replication using an analogy
RNA transcription is a bit like making a cake. The recipe for the cake is written down as a set of instructions, and these are followed to make the finished cake. In the same way, DNA is like the recipe for RNA, and during transcription, these instructions are followed to create new RNA molecules.	rna transcription	Explain RNA transcription using an analogy
RNA transcription is a bit like baking a cake. Just as you need flour, sugar, eggs, and butter to make a cake, you need RNA transcripts, DNA strands, enzymes, and ribosomes to make new RNA molecules. The process of making a cake is started by mixing the ingredients together in the right proportions - just like combining the correct amounts of DNA and enzymes start the transcription process. The ingredients are then put into an oven and cooked at a high temperature - just like the ribosomes translate the RNA transcripts into proteins.	rna transcription	Explain RNA transcription using an analogy
RNA transcription is a bit like making a cake. The recipe for the cake is written down as a set of instructions, and these are followed to create the cake. In the same way, the genetic code that makes up DNA is transcribed into RNA (molecules that carry information) which then carries out the instructions to make proteins.	rna transcription	Explain RNA transcription using an analogy
A musician is reading a sheet of music. She follows the instructions on the page to play certain notes on her instrument. The musician is analogous to RNA, and the sheet of music is analogous to the DNA molecule. The instructions on the page are analogous to the sequence of nucleotides in DNA. Just as the musician plays different notes depending on which page she is reading, so too does RNA produce different proteins based on its sequence.	rna transcription	Explain RNA transcription using an analogy
RNA transcription is a bit like making a copy of a document. The DNA is the original document and the RNA is the copy. Just as with copying a document, there can be mistakes made during transcription, which is why we have variations in different people's genes.	rna transcription	Explain RNA transcription using an analogy
Protein translation could be compared to a machine in a factory. The genetic code is like the blueprint for the machine, and the mRNA is like the instructions that are given to the workers on how to put it together. The ribosomes are like the machines in the factory that actually build the protein.	protein translation	Explain protein translation using an analogy
Protein translation is like a group of people who are learning to speak a new language. The protein molecule is the person, and the sequence of codons (the genetic code) is like the words in that language. As each codon is read by the ribosome, it corresponds to an amino acid, which is then added to the growing protein chain.	protein translation	Explain protein translation using an analogy
Protein translation can be thought of as a factory assembly line. The DNA code is the blueprint for the protein, and it is transcribed into mRNA (molecules that carry the genetic instructions of a gene from the nucleus to the cytoplasm). The mRNA then travels to the ribosomes, where it is read one codon at a time. Each codon corresponds to an amino acid, and so the sequence of codons in the mRNA determines the sequence of amino acids in the protein. tRNA molecules act as translators, bringing each individual amino acid to the ribosome to build up the protein molecule.	protein translation	Explain protein translation using an analogy
Protein translation is a bit like making a pizza. The recipe for the pizza is written in Italian, and a translator translates it into English so that someone in America can make the pizza. In the same way, the genetic code of a protein is written in DNA, and ribosomes translate it into protein.	protein translation	Explain protein translation using an analogy
Protein translation is a bit like making a huge pizza. The recipe for the pizza is written in Italian, and you need to follow all of the steps in order to make a perfect pizza. First, you need to gather all of the ingredients- including flour, water, salt, yeast and tomato sauce. Next, you need to knead the dough using your hands until it's smooth. Then, you let the dough rise for about an hour so that it doubles in size. After that, you roll out the dough into a large rectangle and spread on the tomato sauce. Finally, you add all of your favorite toppings- pepperoni, sausage, green peppers and mushrooms- before baking in a hot oven.The same process happens during protein translation: first DNA is transcribed into RNA , then ribosomes read the RNA sequence and assemble proteins one amino acid at a time . Just like with making pizzas , there are many different steps involved and it takes some time for everything to come together correctly . However , if everything goes according to plan , you'll eventually have a delicious finished product !	protein translation	Explain protein translation using an analogy
An ecosystem is like a big, happy family. Everyone in the family has their own job to do and they all work together to make sure everyone is happy and healthy. The dad is the sun and he provides heat and light for everyone. The mom is the Earth and she provides food, water, and shelter for her children. The kids are the plants and animals and they eat the food provided by their mom, play in the sunshine provided by their dad, and live in shelters built by their mom.	ecosystem	Explain ecosystem using an analogy
An ecosystem is like a big city. The city has different parts that work together to make it run. The people in the city are like the plants and animals in the ecosystem. They all have a role to play and need each other to survive.	ecosystem	Explain ecosystem using an analogy
A human body can be thought of as an ecosystem. The heart is the sun, providing energy to the system. The veins are the rivers, transporting resources throughout the body. The cells are the bacteria and plant life, consuming and transforming resources into waste products that must be eliminated from the system.	ecosystem	Explain ecosystem using an analogy
Like a human body, an ecosystem has many parts that work together to keep things running smoothly. The heart is the ecosystem's beating center, pumping blood (energy) throughout the system. The brain coordinates and oversees all of the activities in the body, while lungs provide oxygen for the bloodstream. Legs and arms allow the body to move around and interact with its surroundings. In much the same way, plants and animals are like organs in an ecosystem, performing different functions to keep everything running smoothly. The sun is like the body's energy source, providing light and heat that fuels life on Earth. Rivers and oceans act as transportation systems, carrying nutrients from one place to another. Rocks and soil create a stable foundation for ecosystems to thrive on.	ecosystem	Explain ecosystem using an analogy
An ecosystem can be thought of as a community of different plants and animals living in close proximity to one another. The plants provide food and shelter for the animals, while the animals help to pollinate the plants and spread their seeds. If one part of the ecosystem is disrupted, it can have a ripple effect throughout the entire community.	ecosystem	Explain ecosystem using an analogy
An action potential is like a wave that travels down a neuron. It starts at the neuron's cell body and moves down its axon to the end of the axon where it causes the release of neurotransmitters.	propagation of an action potential down a neuron	Explain propagation of an action potential down a neuron using an analogy
An action potential is like a wave of energy that travels down a neuron. It starts at the point where the neuron has been stimulated and moves along the cell until it reaches the end.	propagation of an action potential down a neuron	Explain propagation of an action potential down a neuron using an analogy
When someone steps on a metal plate that has an electric current running through it, the person's body will become electrified. This is because when you step on the metal plate, it creates a pressure difference between your foot and the rest of your body. This pressure difference causes electrons to flow from your foot to the rest of your body. The same thing happens in a neuron when an action potential moves down its axon.	propagation of an action potential down a neuron	Explain propagation of an action potential down a neuron using an analogy
The propagation of an action potential down a neuron can be thought of as the flow of electricity through a wire. An action potential causes voltage-sensitive gates to open, which allows electrically charged ions to flow into and out of the neuron. This flow of ions creates an electrical current that travels down the neuron until it reaches the end.	propagation of an action potential down a neuron	Explain propagation of an action potential down a neuron using an analogy
A neuron is like a telephone line. When you pick up the phone and press down on the key, it sends an electrical current down the line. This current travels to the other end of the line where it causes the phone at that end to ring. An action potential is just like pressing down on that key. It creates an electrical current that travels down the neuron until it reaches its destination.	propagation of an action potential down a neuron	Explain propagation of an action potential down a neuron using an analogy
The frog's respiratory system is similar to a human's. The frog has lungs which are filled with air when the frog inhales. When the frog exhales, the carbon dioxide in its blood is expelled and fresh oxygen enters the bloodstream. This happens because of tiny holes (called alveoli) in the lungs which allow oxygen and carbon dioxide to pass into and out of them.	breathing mechanism of frogs	Explain breathing mechanism of frogs using an analogy
Frogs breathe in a similar way to humans. They suck in air through their noses, and the oxygen is then transported through their bloodstream to different parts of their body. Frogs can also hold their breath for quite a long time if they need to, which helps them stay underwater while hunting for food	breathing mechanism of frogs	Explain breathing mechanism of frogs using an analogy
Breathing mechanism of frogs is similar to that of humans. It involves the use of ribs and muscles to draw air into and expel it from the lungs. The analogy would be like two people using a bicycle pump to inflate and deflate a balloon.	breathing mechanism of frogs	Explain breathing mechanism of frogs using an analogy
Breathing mechanism of frogs can be compared to a car engine. The frog's heart acts as the engine and the lungs act as the exhaust system. When the frog inhales, it draws in air through its nose or mouth. This air travels down its throat, into its chest and then into its lungs. The lungs extract oxygen from the air and send it through the bloodstream to the rest of the body. When the frog exhales, it pushes carbon dioxide out of its lungs and back out through its nose or mouth.	breathing mechanism of frogs	Explain breathing mechanism of frogs using an analogy
Frogs breathe in a way that is similar to humans. They use their lungs to take in air, which then travels through tiny blood vessels (capillaries) into the frog's body. The oxygen in the air diffuses through the capillary walls and enters the frog's bloodstream. Carbon dioxide, which is waste gas produced by cells, diffuses out of the bloodstream and back into the lungs, where it is exhaled.	breathing mechanism of frogs	Explain breathing mechanism of frogs using an analogy
A layered architecture is like a cake. The bottom layer is the foundation, which provides stability and strength. On top of that is the filling, which adds flavor and texture. Finally, the icing on top makes it look pretty and completes the cake.	layered architecture	Explain layered architecture using an analogy
A cake is a good analogy for layered architecture. The bottom layer is the foundation, it's strong and sturdy and holds up the rest of the cake. The next layer is the cake itself, it's made of many different flavors and textures that make it unique. Then you have the frosting on top, which can be any flavor or color you want. It's a way to top off your cake and make it look special.	layered architecture	Explain layered architecture using an analogy
A cake is like a computer program. The cake’s layers are analogous to the different parts of the program. The frosting on top is like the user interface, while the layer of cake below it is like the underlying code that powers everything.	layered architecture	Explain layered architecture using an analogy
Layers of an onion analogy: Just as an onion has many layers that can be peeled away one by one, a layered architecture also has multiple levels that can be accessed and modified. The outermost layer is the user interface, which the average person sees and interacts with. Beneath this are several other layers of code or functionality that are hidden from view but still affect how the application works. This modular design allows developers to isolate different aspects of the program and make changes without affecting the rest of the system.	layered architecture	Explain layered architecture using an analogy
A layered architecture is like a cake. The bottom layer is the foundation, which supports the rest of the cake. The next layer up is the crust, followed by the filling and finally the frosting on top. Each layer depends on the ones below it to be stable. In software engineering, a layered architecture is a way of organizing an application into modular components. Each layer in this type of architecture provides specific functionality, while relying on other layers for services it cannot provide itself.	layered architecture	Explain layered architecture using an analogy
A cake recipe may require 2 cups of sugar and 1 cup of butter. If a baker only has 1 cup of sugar, they can still make the cake, but it will be smaller than if they had 2 cups of sugar. The sugar is the limiting reactant because it is in short supply. The butter is the excess reactant because there is more than enough to complete the reaction.	limiting reactant and excess reactant	Explain limiting reactant and excess reactant using an analogy
A limiting reactant is like a traffic jam on the highway. The more cars that try to get through, the slower everything moves. Eventually, there will be so many cars that no more can fit and movement comes to a standstill. In the same way, a limiting reactant is what limits how much product can be formed in a reaction. The excess reactant is like all of the other lanes on the highway - it's not causing any problems and just flows along at its own pace.	limiting reactant and excess reactant	Explain limiting reactant and excess reactant using an analogy
One way to think about it is as though you are baking a cake. In order to make the cake, you need flour, sugar, eggs, butter and baking powder. These ingredients are all necessary for the cake to be made. However, if you only have one egg left, then you cannot make the cake because that is not enough eggs. The flour and sugar can still be used even if there are not enough eggs because they are not essential for making the cake. On the other hand, if you have ten eggs but no flour or sugar, then you also cannot make the cake because those ingredients are necessary too.	limiting reactant and excess reactant	Explain limiting reactant and excess reactant using an analogy
A cake recipe might require two cups of sugar and one cup of butter. If you only have one and a half cups of sugar, the recipe will not work because there is not enough sugar to make a cake. The sugar is the limiting reactant; it will be used up first and no more cake can be made. The butter is the excess reactant; once the sugar is gone, there is still plenty of butter left over to make a cake.	limiting reactant and excess reactant	Explain limiting reactant and excess reactant using an analogy
A limiting reactant is like a traffic jam on the highway. The cars (reactants) are still moving, but they can't all get through at once. So some cars have to wait until later. An excess reactant is like having extra lanes on the highway. More cars can get through and the traffic moves faster.	limiting reactant and excess reactant	Explain limiting reactant and excess reactant using an analogy
A eukaryotic cell is like a city. The nucleus is the mayor, the mitochondria are the power plants, and the ribosomes are the factories.	eukaryotic cell	Explain eukaryotic cell using an analogy
A eukaryotic cell is like a city. The nucleus is the mayor, and the mitochondria are the factories. The proteins are the workers, and the DNA is the blueprint.	eukaryotic cell	Explain eukaryotic cell using an analogy
A eukaryotic cell is a bit like a city. The cell has many different parts that all work together to keep the city running. The nucleus is the mayor, who makes decisions for the whole city. The mitochondria are the power plants, providing energy for everything else. The cells walls are like the city gates, keeping things in and out. And finally, the cytoskeleton is like the roads and bridges, connecting everything together.	eukaryotic cell	Explain eukaryotic cell using an analogy
A eukaryotic cell can be thought of as a city. The nucleus is the mayor, controlling what goes on in the city. The mitochondria are the power plants, providing energy for the city. The cytoskeleton is like the roads and bridges, keeping everything organized and connected. The plasma membrane is like the walls of the city, separating it from its surroundings. And lastly, the cells themselves are like all of the citizens of the city, each with their own unique set of functions that contribute to making the whole thing work	eukaryotic cell	Explain eukaryotic cell using an analogy
Eukaryotic cells are like cities. They have many different parts that work together to keep the cell running. The nucleus is the city hall, where all of the important decisions about the cell are made. The mitochondria are the power plants, providing energy for the cell. The cytoskeleton is like the roads and bridges, allowing things to move around inside of the cell. And finally, the plasma membrane is like the city walls, keeping everything inside safe and separate from outside environments.	eukaryotic cell	Explain eukaryotic cell using an analogy
A prokaryotic cell is like a small village. The cells in the village all work together to keep things running smoothly.	prokaryotic cell	Explain prokaryotic cell using an analogy
A prokaryotic cell is like a small city. It has all the essential components to function, including factories (ribosomes), a power plant (mitochondria), and homes for the citizens (cytoplasm). The cells also have defense mechanisms to protect themselves from invaders.	prokaryotic cell	Explain prokaryotic cell using an analogy
A prokaryotic cell is like a small city. It has all the functions of a city (respiration, DNA replication, etc.), but it is much smaller in size.	prokaryotic cell	Explain prokaryotic cell using an analogy
A prokaryotic cell is like a small, independent town. The town has all the basic necessities for survival (like food and shelter), but it's run by the people who live there, not some outside authority. Similarly, prokaryotic cells have all the essentials for life (like DNA and enzymes), but they're self-sufficient, meaning they produce their own energy and nutrients.	prokaryotic cell	Explain prokaryotic cell using an analogy
A prokaryotic cell is like a small city. It has all the same functions as a city, but on a much smaller scale. The cells have factories that produce goods, homes for the citizens (proteins and DNA), a transportation system to move things around, and trash disposal.	prokaryotic cell	Explain prokaryotic cell using an analogy
Imagine you are a passenger in a car. The driver is the operating system kernel. It manages all of the resources of the car - the engine, the fuel, the steering, the brakes, and so on. It also manages all of the passengers - their seating position, their safety belts, and so on. In much the same way, an operating system kernel manages all of the resources of a computer system and all of its users.	operating systems kernel	Explain operating systems kernel using an analogy
An operating system kernel is like the brain of a human. It controls all the functions of the body and keeps everything running smoothly.	operating systems kernel	Explain operating systems kernel using an analogy
An operating system kernel is like a human brain. It controls the overall function of the computer and provides an interface between the user and the hardware. The kernel is responsible for allocating resources, scheduling tasks, handling interrupts, and controlling access to files and other resources.	operating systems kernel	Explain operating systems kernel using an analogy
An operating system kernel can be thought of as the "heart" of a computer. Just like your heart circulates blood throughout your body, the kernel distributes information and tasks to different parts of the computer. It also manages communication between different software applications and hardware components.	operating systems kernel	Explain operating systems kernel using an analogy
An operating system kernel is like the brain of a human. It controls everything that goes on and coordinates all the different parts of the body.	operating systems kernel	Explain operating systems kernel using an analogy
A limiting reactant is like a traffic jam. The more cars that try to go through the intersection, the slower everything gets until there's a standstill. In the same way, the more of one chemical we add to a reaction mixture, the slower everything gets until one of the chemicals runs out and no more reaction can take place	limiting reactant	Explain limiting reactant using an analogy
A lobster pot is a good analogy for how a limiting reactant works. You can put as many lobsters in the pot as you want, but once there are too many and they start to fill up the space, no more can fit. The same thing happens with a chemical reaction - only so much of one substance (the limiting reactant) can be used up before the reaction stops.	limiting reactant	Explain limiting reactant using an analogy
One analogy for a limiting reactant is that it's like a cake recipe. The recipe might call for two cups of flour, one cup of sugar, and one egg. If you only have one egg, you can still make the cake, but you'll only be able to use half as much flour and sugar. So even though both ingredients are present in the same quantity, the effect of each is diminished because they're not working together in the same way.	limiting reactant	Explain limiting reactant using an analogy
A limiting reactant is like a traffic jam. The more cars that try to get through the intersection, the slower it gets. Eventually, there will be so many cars at the intersection that no more cars can get through. In this analogy, the cars are molecules and the intersection is the reaction site.	limiting reactant	Explain limiting reactant using an analogy
A car needs gasoline to run. The gasoline is the limiting reactant because it determines how far the car can go. No matter how much oil, water, or other parts are in the car, it will not move if there is no gas.	limiting reactant	Explain limiting reactant using an analogy
Helicase is a bit like a staircase. It helps to carry DNA up and down the stairs, so that it can be copied accurately.	helicase	Explain helicase using an analogy
Helicase is a bit like a human hair. It is made up of many smaller strands that work together to create one larger whole. The helicase strand winds around the DNA molecule, like a thread around a spool, and helps to “unzip” it so that the genetic information can be read and used by the cell.	helicase	Explain helicase using an analogy
Helicase is like a lock that needs a key to work. The key in this analogy is the enzyme DNA polymerase, which helps helicase unwind the DNA double helix so it can be copied.	helicase	Explain helicase using an analogy
A helicase is like a motor that helps to untangle DNA strands. Imagine if you had a big pile of tangled phone cords. To fix the problem, you would need to use a motor (the helicase) to help straighten out the cords.	helicase	Explain helicase using an analogy
Helicase is like a person who uses a ladder to climb up to the roof of a house. The person climbs up the ladder one step at a time, and as they do, they use their hands to keep the ladder from slipping away from them. Helicase works in a similar way: it uses its hands (the ATPases) to grip onto the DNA molecule, and then it pulls itself along using its feet (the helicases).	helicase	Explain helicase using an analogy
Replication binding proteins are like the locks on a safe. The DNA is like the valuable treasure that needs to be protected. The replication binding proteins keep the DNA from being accessed by anyone who doesn't have the key, which is the enzyme that copies the DNA.	dna replication binding proteins	Explain DNA replication binding proteins using an analogy
Binding proteins can be thought of as traffic cops. They help regulate the flow of replication enzymes to ensure that DNA is accurately copied.	dna replication binding proteins	Explain DNA replication binding proteins using an analogy
DNA replication binding proteins are like the nails that hold a picture frame to the wall. They help keep the DNA strands together as they replicate.	dna replication binding proteins	Explain DNA replication binding proteins using an analogy
Replication binding proteins can be compared to the bolts that hold a car together. The bolts are essential for holding the car together, and they must be tight in order to keep the car from falling apart. In a similar way, replication binding proteins are essential for DNA replication and must be tightly bound in order to ensure accurate replication.	dna replication binding proteins	Explain DNA replication binding proteins using an analogy
DNA replication binding proteins can be thought of as the "glue" that holds DNA together while it is being copied.	dna replication binding proteins	Explain DNA replication binding proteins using an analogy
If you can imagine a bunch of people standing in a line, and someone needs to get from the back of the line to the front, that person could ask anyone in the line to let them move up. The person at the front of the line is like a ligase enzyme because they are able to connect two DNA strands together.	ligase	Explain ligase using an analogy
Ligase is like a glue that holds DNA together. It helps to keep the strands of DNA together so they can be replicated accurately.	ligase	Explain ligase using an analogy
A ligase is similar to a connector. It connects two pieces of DNA together, much like how a connector joins two electrical wires together.	ligase	Explain ligase using an analogy
Ligase is a bit like a glue, it helps to stick things together. In the context of DNA, ligase helps to join together two pieces of DNA that have been cut apart by restriction enzymes	ligase	Explain ligase using an analogy
A ligase is like a superglue that can hold pieces of metal together. It can also be used to glue two pieces of DNA together.	ligase	Explain ligase using an analogy
Process control block can be thought of as a traffic cop at an intersection. The cop manages the flow of traffic, ensuring that cars go through the intersection in an orderly fashion and don't back up. In the same way, a process control block oversees the execution of a process, making sure that it proceeds smoothly and doesn't get bogged down.	process control block	Explain process control block using an analogy
A process control block can be thought of as a traffic controller for the flow of information between different parts of a computer system. Just like how a traffic controller manages the flow of cars on a highway, the process control block directs the flow of information between different components in a computer system. This helps to ensure that data is transmitted correctly and efficiently, which helps to improve overall system performance.	process control block	Explain process control block using an analogy
A process control block can be thought of as a traffic controller at an intersection. The traffic controller ensures that cars are properly processed through the intersection, preventing collisions and ensuring that everyone arrives safely at their destination. In the same way, a process control block oversees the processing of data through a program, ensuring that no errors occur and that all pieces of data arrive safely at their destination.	process control block	Explain process control block using an analogy
A process control block is sort of like a traffic controller for a busy intersection. The traffic controller ensures that cars are flowing through the intersection smoothly and safely. In the same way, the process control block oversees the execution of processes on a system, making sure that they are running efficiently and without errors.	process control block	Explain process control block using an analogy
A process control block can be thought of as a traffic controller for the flow of information through a computer system. The process control block manages the resources that are allocated to each process and ensures that the processes run in an orderly fashion. It also keeps track of any errors that occur during the execution of a process.	process control block	Explain process control block using an analogy
Message encoding is like putting a letter in an envelope. The message (letter) is the content, and the envelope is the encoding.	message encoding	Explain message encoding using an analogy
message encoding is like translating a book from one language to another. the original message (book) is written in one language, and then it is translated into another language using a specific code. this code tells the translator how to convert each letter or word from the original language into the new language.	message encoding	Explain message encoding using an analogy
Message encoding is like translating a book from English to Spanish. The original message (book) is still there, but it's been translated so that people who speak Spanish can understand it.	message encoding	Explain message encoding using an analogy
Message encoding is similar to translating a word from one language to another. The message is converted into a code that can be read by the computer.	message encoding	Explain message encoding using an analogy
One way to encode a message is like putting it in a locked box. The box has a specific code that can be used to unlock it. Only the person who knows the code can open the box and read the message.	message encoding	Explain message encoding using an analogy
Interaction between drugs and receptor sites can be likened to two people shaking hands. The drug is like the person extending their hand, while the receptor site is like the person receiving the handshake. When they interact, each one affects the other in some way.	interaction between drugs and receptor sites	Explain interaction between drugs and receptor sites using an analogy
Imagine a person is holding a basketball. Now imagine someone else trying to take the ball from them by reaching their hand out and grabbing it. The first person would likely resist, using all of their strength to keep hold of the ball. This is similar to how drugs interact with receptor sites. The drug is like the person holding onto the ball, while the receptor site is like the other person trying to take it from them.	interaction between drugs and receptor sites	Explain interaction between drugs and receptor sites using an analogy
Interaction between drugs and receptor sites is a bit like two puzzle pieces fitting together. The drug is the puzzle piece, while the receptor site is the other piece that it fits into. When they come together, they create a whole new entity - in this case, the drug's effects on the body.	interaction between drugs and receptor sites	Explain interaction between drugs and receptor sites using an analogy
Think of drug-receptor interaction as a lock and key. The drug is the key, and the receptor site is the lock. When they interact, it's like the two pieces fit perfectly together. This allows the drug to do its job by binding to the receptor site and altering its function.	interaction between drugs and receptor sites	Explain interaction between drugs and receptor sites using an analogy
Drugs and receptor sites can be thought of as keys and locks. The drug is the key, and the receptor site is the lock. When the key (drug) fits into the lock (receptor site), it unlocks the door (causes a response).	interaction between drugs and receptor sites	Explain interaction between drugs and receptor sites using an analogy
A monitor is like a television screen. It displays the images that are sent to it by a computer.	monitor	Explain Monitor using an analogy
A monitor is like a TV. It displays information that you can see and interact with.	monitor	Explain Monitor using an analogy
A monitor is like a television. It displays images that have been sent to it from a computer or other device.	monitor	Explain Monitor using an analogy
A monitor is like a TV. It is a device that shows pictures and videos.	monitor	Explain Monitor using an analogy
A Monitor is like a TV. It has a screen that you can look at and it shows you what is happening on your computer.	monitor	Explain Monitor using an analogy
A CPU is a bit like a soccer referee. It monitors the game, makes sure that everyone follows the rules, and intervenes when something goes wrong. In the same way, a CPU monitors the programs running on your computer, makes sure that they obey the rules (of memory management for example), and steps in when something goes wrong.	cpu	Explain CPU using an analogy
A CPU can be thought of as a tiny kitchen. When you are cooking, you need different ingredients to make a dish. The same is true for the CPU. It needs different parts (called cores) to complete tasks.	cpu	Explain CPU using an analogy
A CPU is like a small town. The town has a grocery store, a bank, a post office, and other stores. The residents of the town can go to these stores to buy what they need. The CPU has different parts that work together to run programs and applications. These parts are like the stores in the town. The CPU has a processor, which is like the grocery store. It has memory, which is like the bank. And it has storage, which is like the post office	cpu	Explain CPU using an analogy
A CPU can be thought of as a brain. It processes information and makes decisions just like our brains do.	cpu	Explain CPU using an analogy
When you go to the movies, there are multiple screens in front of you. If one screen is showing a movie that you're not interested in, you can focus on one of the other screens. CPUs work in a similar way - they have multiple processing cores (screens), and if one core is working on a task that doesn't interest you, you can use another core to do something else.	cpu	Explain CPU using an analogy
A motherboard can be thought of as the skeleton or foundation upon which a computer is built. It houses and connects all of the key components, such as the processor, memory, graphics card, and hard drive.	motherboard	Explain motherboard using an analogy
A motherboard can be thought of as the "backbone" of a computer. It is essentially a large circuit board that holds all of the essential components of a PC. This includes things like the CPU, memory, and storage drives. The motherboard also provides connectors for attaching other parts like video cards, sound cards, and Ethernet adapters.	motherboard	Explain motherboard using an analogy
A motherboard can be thought of as the spine of a computer. It holds all of the key components in place and allows them to communicate with one another.	motherboard	Explain motherboard using an analogy
If you think of the motherboard as the skeleton, then think of the CPU as the brain. The other components of the computer, like the hard drive, memory, and ports, are all like organs that plug into and work with the skeleton to make everything run.	motherboard	Explain motherboard using an analogy
A motherboard can be thought of as the spine of a computer. It's a large, rectangular circuit board that everything else plugs into. The processor, memory, and graphics cards all connect to the motherboard. So does the power supply, hard drive, and other components.	motherboard	Explain motherboard using an analogy
If you think of your computer's memory as a room, RAM would be the furniture in that room. It's there when you need it, and when you're done using it, it disappears until you need it again.	ram	Explain RAM using an analogy
RAM is like a desk. You can put things on the desk, and you can take them off the desk. The things on the desk (in RAM) are accessible to you as long as the desk is in your room. If someone else comes into your room and takes the desk away, then the things on it (in RAM) are no longer accessible to you.	ram	Explain RAM using an analogy
RAM is like a library where you can borrow books. When you have a book in your hand, you are borrowing it from the library. You can read the book and then return it to the library. The next person who wants to borrow that book can do so because the book is still at the library. RAM works in a similar way. The data that is stored in RAM is available for use by programs running on your computer. When you finish using a program, its data is automatically removed from RAM so that someone else can use that space for their own program.	ram	Explain RAM using an analogy
RAM can be thought of as short-term memory. When you are working on a document and need to save it, RAM is where the document is stored until it is saved to your computer's hard drive.	ram	Explain RAM using an analogy
RAM is kind of like a desk. You can put things on it and take them off whenever you want. The only difference is that RAM is electronic, not physical.	ram	Explain RAM using an analogy
A power supply unit can be analogized to a water tower. The water tower provides a consistent and reliable flow of clean water to the various faucets in the city, keeping everyone hydrated. Similarly, the power supply unit provides a steady stream of electricity to all of the devices in your home or office, keeping them powered up.	power supply unit	Explain Power supply unit using an analogy
A power supply unit can be compared to a gas station for a car. Just as the gas station provides fuel for the car, the power supply unit provides electricity to your computer.	power supply unit	Explain Power supply unit using an analogy
A power supply unit is a lot like the battery in your car. It stores energy so that it can be used when it is needed. The power supply unit takes electricity from the wall and converts it into a form that can be used by the computer.	power supply unit	Explain Power supply unit using an analogy
A power supply unit can be thought of as a water tower. The power supply unit provides a steady flow of electricity to all the components in your computer, just like the water tower provides a steady flow of water to all the homes in the town.	power supply unit	Explain Power supply unit using an analogy
A power supply unit can be thought of as a water tower. The water tower provides a consistent and reliable source of water to the city, while the power supply unit provides a consistent and reliable source of electricity to the city.	power supply unit	Explain Power supply unit using an analogy
The keyboard is like a piano. You press the keys to make different notes come out.	keyboard	Explain Keyboard using an analogy
To use a keyboard, pretend you are driving a car. The left hand is on the wheel and the right hand is on the gearshift. Your feet are on the pedals. To move the car forward, you would press down on the gas pedal with your right foot. To move the car back, you would press down on the brake pedal with your left foot.	keyboard	Explain Keyboard using an analogy
I can think of the keyboard as a group of people who live in a big house. Each person has their own room, and each room is assigned a specific letter on the keyboard. When you want to talk to someone, you go to their room and knock on the door. To type something, you just walk into your room and start talking (or typing).	keyboard	Explain Keyboard using an analogy
A keyboard is like a typewriter, but with more letters.	keyboard	Explain Keyboard using an analogy
A keyboard is like a collection of musical keys. Just as pressing different keys on a piano produces different notes, pressing different buttons on a keyboard produces different letters and symbols.	keyboard	Explain Keyboard using an analogy
Mouse is like a tiny person who lives in your computer. They help you control what's on the screen and can do many things to make your experience better.	mouse	Explain mouse using an analogy
A mouse is like a tiny little person who lives in your computer. They help you move around and do things on the screen.	mouse	Explain mouse using an analogy
A mouse is a small, furry creature that scurries around under furniture. It is often used as a metaphor for something small and insignificant.	mouse	Explain mouse using an analogy
Mouse usage can be compared to a person using a computer mouse. Moving the mouse around on the surface moves the cursor on the screen, and clicking or pressing down on the mouse button will select or activate whatever it is pointing at.	mouse	Explain mouse using an analogy
Mouse is like a tiny person who lives inside your computer. When you move the mouse around on your desk, it sends signals to the computer telling it where to go.	mouse	Explain mouse using an analogy
An audio card can be thought of as a translator. It takes the digital information from your computer (1's and 0's) and turns it into sound that you can hear.	audio card	Explain audio card using an analogy
If you can think of your computer's sound card as a musician, it would be like someone who can play the guitar, drums, and sing all at the same time. Your computer's audio card is responsible for processing all of the different sounds that are coming into your system so that they come out sounding clean and clear.	audio card	Explain audio card using an analogy
An audio card is like a musician. The audio card can play different instruments (sounds) and control the volume of each instrument.	audio card	Explain audio card using an analogy
An audio card is like a musician. The musician can play different instruments (sounds) and make music. The audio card can play different sounds too, and make music with them.	audio card	Explain audio card using an analogy
The audio card is like the engine of a car. It takes input from various devices (like the gas pedal, brakes, and steering wheel) and turns it into motion that makes the car move. The audio card takes input from your music player, microphone, and other devices and translates it into sound that you can hear.	audio card	Explain audio card using an analogy
A video card is like a fast sports car. It has a lot of horsepower and can quickly move data around to create the images on your screen.	video card	Explain video card using an analogy
A video card is a bit like a driver's license. It's a piece of plastic that proves you're allowed to do something. In this case, the "something" is drive a car. A video card does the same thing for your computer—it proves you're allowed to use the graphics hardware on your motherboard to display things on your screen.	video card	Explain video card using an analogy
A graphics card is a bit like a car. It has an engine (the GPU) that does the hard work, and it has some basic features that you need in order to drive it (memory, outputs, etc). The better the engine in the car, the faster and more powerful it will be. The same is true for GPUs - the better the chip, the faster and more powerful your graphics card will be.	video card	Explain video card using an analogy
A video card is a little like your TV. It takes the signal from your computer and turns it into a picture that you can see on your screen.	video card	Explain video card using an analogy
A video card is like a turbocharger for your car. It makes the process of displaying graphics on the screen faster and smoother, allowing you to play games or watch videos with improved clarity and without any lag.	video card	Explain video card using an analogy
The age of a tree is like the number of years you have been alive. Just as you cannot remember your life before you turned one year old, a tree cannot remember its growth before it was planted.	tree's age calculation	Explain tree's age calculation using an analogy
To calculate the age of a tree, you would have to count how many times the tree's trunk has been divided by the number of rings on the trunk. This is like counting how many years have passed since the tree was planted.	tree's age calculation	Explain tree's age calculation using an analogy
The tree's age calculation is like counting down from a hundred. The tree is 100 years old, the year after it is 99 years old, and so on.	tree's age calculation	Explain tree's age calculation using an analogy
The age of a tree is like the number of years someone has been alive. Just as you can't add up all the days someone has been alive to get their age, you can't add up all the rings on a tree's trunk to get its age. You have to use a formula that takes into account how big the tree was when it first started growing rings.	tree's age calculation	Explain tree's age calculation using an analogy
A tree's age calculation is like a human's age calculation. Just as humans are measured in years since they were born, trees are measured in rings since they grew their first ring. So, just as someone who is 25 years old has lived for 25 years, a tree that has 20 rings has been growing for 20 years.	tree's age calculation	Explain tree's age calculation using an analogy
A marathon runner can get tired because her body is not able to produce enough energy. Her muscles need a continuous supply of energy to keep running, which they get from the food she eats. After eating, her digestive system breaks down the food into molecules that her cells can use for energy. One process that provides energy for muscle cells is glycolysis. In glycolysis, the cell takes glucose (a molecule made up of six carbon atoms) and splits it into two three-carbon molecules called pyruvates. The pyruvates are then turned into adenosine triphosphate (ATP), which provides the cell with a lot of energy.	glycolysis	Explain glycolysis using an analogy
Glycolysis is like a factory that produces energy. The workers in the factory are called enzymes and they produce energy by breaking down glucose, which is like the raw materials that they work with.	glycolysis	Explain glycolysis using an analogy
Glycolysis is like a factory that takes in raw materials and produces something useful. The raw material in glycolysis is glucose, which is broken down into two molecules of pyruvate. Pyruvate is then used to produce energy in the form of ATP.	glycolysis	Explain glycolysis using an analogy
Glycolysis is like a factory that takes raw materials and turns them into products. The raw materials are glucose, oxygen, and ATP. The products are pyruvate, NADH, and water.	glycolysis	Explain glycolysis using an analogy
Glycolysis is like a car. The fuel (glucose) is the input and the energy that it produces is the output. The car's engine takes in the fuel and breaks it down into smaller parts. These parts are then used to power the car's movement. Glycolysis does something similar; it takes in glucose and breaks it down into smaller molecules called pyruvate. Pyruvate can then be used by the body to create energy.	glycolysis	Explain glycolysis using an analogy
When light shines on a butterfly, some of the light scatters off the wings in every direction. This is called diffuse reflection. Some of the light also reflects off the body of the butterfly in a particular direction. This is called specular reflection. If you shine a flashlight at a mirror, you will see mostly specular reflection because most of the light reflects off the surface in one direction.Anti-stokes scattering occurs when some of the scattered light goes in the opposite direction from where it was originally emitted. It is very rare for this to happen and usually only happens with high energy particles or photons.	anti-stokes scattering	Explain anti-stokes scattering using an analogy
One analogy for anti-Stokes scattering is the way a tennis ball bounces off of a concrete wall. When the tennis ball hits the wall, it rebounds in the opposite direction with more speed than it had when it hit the wall. This is because some of the energy from the impact was transferred to pushing against the air molecules around the ball, causing them to move faster and create an opposing force that pushes back on the ball. In anti-Stokes scattering, light particles (like tennis balls) rebound in the opposite direction of their original motion, but they lose energy in doing so.	anti-stokes scattering	Explain anti-stokes scattering using an analogy
If you throw a tennis ball at a wall, the ball will bounce back. This is an example of Newton's third law of motion, which states that for every action there is an equal and opposite reaction. When the tennis ball hits the wall, it pushes against the wall with force. The wall then pushes back against the tennis ball with equal force, sending it bouncing back in the other direction.	anti-stokes scattering	Explain anti-stokes scattering using an analogy
One analogy for anti-Stokes scattering is the way in which a stone thrown into a still pond creates waves that spread out from the point of impact. The energy released by the stone as it hits the water sets off a chain reaction of ripples that move outward in all directions. In much the same way, light particles can create small disturbances (known as phonons) when they collide with other atoms or molecules. These phonons then propagate through the material, sacrificing some of their energy along the way. If an atom or molecule absorbs one of these phonons, it will start to emit light in the opposite direction—hence anti-Stokes scattering.	anti-stokes scattering	Explain anti-stokes scattering using an analogy
An analogy for anti-stokes scattering is a person trying to shout at someone who is far away. The sound waves created by the person's voice will be scattered in all directions, and most of them will not reach the other person.	anti-stokes scattering	Explain anti-stokes scattering using an analogy
Stokes scattering is similar to the way light scatters off of a diamond. Just as light reflects off of a diamond, it also scatters off of individual particles in the atmosphere. The blue color that we see in the sky is the result of shorter-wavelength light being scattered more than longer-wavelength light.	stokes scattering	Explain stokes scattering using an analogy
If you throw a stone into a pond, the water will ripple outwards. This is because when the stone hits the water, it pushes some of the water molecules out of the way. These displaced molecules then push on their neighbours, and so on until the whole pond is rippling.Stokes scattering works in a similar way. When light hits an object, it pushes some of the object's atoms or molecules out of its way. These displaced atoms or molecules then push on their neighbours, and so on until the whole object is glowing with light.	stokes scattering	Explain stokes scattering using an analogy
A soccer ball is kicked into the air and a player tries to catch it. As the ball rises, the wind pushes it around. The player has to move his or her hands around to keep up with the ball. This is similar to what happens when light hits a particle. The light scatters off of the particle in all directions.	stokes scattering	Explain stokes scattering using an analogy
Stokes scattering is a bit like throwing a stone into a pond. When you throw the stone in, it creates small ripples that spread out across the surface of the water. These ripples represent the light waves that are being scattered by the object.	stokes scattering	Explain stokes scattering using an analogy
Lorraine is throwing a beach ball into the air and catches it. As she throws it up, the ball scatters sunlight in all directions. This is an example of stokes scattering.	stokes scattering	Explain stokes scattering using an analogy
The median lethal dose is the amount of a substance that is required to kill half of the members of a tested population. It can be thought of as the amount of a substance that is required to make an animal "half dead."	median lethal dose	Explain Median Lethal Dose using an analogy
The median lethal dose is the amount of a substance that is required to kill half of the members of a tested population within a specified time frame. This analogy might help you understand it better.Imagine there are 100 people in a room and you have to kill 50 of them. You could do it one by one, but that would take a long time. Alternatively, you could pour poison into the air vents and let it distribute evenly throughout the room. Within minutes, half of the people will be dead. This is analogous to how the median lethal dose works—it's an easily administered measure that kills 50% of the test population quickly.	median lethal dose	Explain Median Lethal Dose using an analogy
A median lethal dose is the amount of a particular substance that will kill half of a test population given a certain period of time. It can be thought of as the "middle ground" between a dosage that is too low to have any effect and one that is high enough to cause death. To put it another way, if you imagine all possible doses of a substance lined up from lowest to highest, the median lethal dose would be right in the middle - meaning that half of those who take it will die, while the other half won't suffer any ill effects.	median lethal dose	Explain Median Lethal Dose using an analogy
The Median Lethal Dose (LD50) is the dose of a substance that kills 50% of the test population. This can be thought of as the "poisonous" dose. An analogy would be to think of it as the dosage of a medicine that will kill half of those who take it, if taken in one dose.	median lethal dose	Explain Median Lethal Dose using an analogy
A median lethal dose (LD50) is the amount of a toxin, such as poison, that is required to kill 50 percent of a population of test animals within a given period of time. The LD50 can be expressed in milligrams per kilogram of body weight or in micrograms per liter of blood plasma.The LD50 can be compared to the dosage of a medicine. If the dosage needed to cure 50% of the patients were known, then this would be called the therapeutic index and would serve as an indication of how safe the drug might be.	median lethal dose	Explain Median Lethal Dose using an analogy
The universe can be thought of as a large container filled with water. The water represents all the matter and energy in the universe. The container is like the space that the universe occupies. It has no end or beginning, just like space has no end or beginning.	universe	Explain Universe using an analogy
I can't explain the universe using an analogy.	universe	Explain Universe using an analogy
The universe is like a big ocean. There are all sorts of different creatures in it, from tiny fish to huge whales. The planets and stars are like the rocks on the ocean floor, and the sun is like the bright light shining down from above.	universe	Explain Universe using an analogy
The universe is like an apple. The apple has a skin, a core, and flesh. The skin is the universe's outer layer. The core is the center of the apple where the seeds are located. The flesh is the part of the apple that we eat. Just like there is a skin, core, and flesh on an apple, there is a surface layer, interior layer, and innermost layer to the universe.	universe	Explain Universe using an analogy
The universe can be thought of as a large container filled with water. The water represents everything that exists in the universe, including planets, stars, and galaxies. Just as waves form on the surface of the water when it is disturbed, events taking place in the universe cause ripples to spread outwards. These ripples are like mini-explosions that carry information about what has happened all across space and time.	universe	Explain Universe using an analogy
The analogy of an enzyme is a key. The lock (enzyme substrate) is like a door that needs to be opened. The key (enzyme) has the perfect shape to fit into the Lock and turn it so the door can open.	enzyme mechanism	Explain enzyme mechanism using an analogy
Enzymes are like tiny machines that help to speed up chemical reactions in the body. An enzyme analogy would be a tiny robot that helps to put together a car faster than if you did it by hand.	enzyme mechanism	Explain enzyme mechanism using an analogy
An enzyme is like a key that unlocks a door. The substrate (the thing the enzyme needs to work on) is like the door, and the active site of the enzyme is like the lock. The substrate fits into the active site of the enzyme like a key in a lock, and when it does, it changes shape so that the enzymes can start working on it.	enzyme mechanism	Explain enzyme mechanism using an analogy
Enzyme action can be compared to the way a lock works. The key (enzyme) fits into the lock (active site on the enzyme molecule) and, as it is turned, the tumblers inside the lock are moved until they line up with the corresponding notch on the key. This allows the door (substrate molecule) to open.	enzyme mechanism	Explain enzyme mechanism using an analogy
Imagine you are at a carnival and trying to win a stuffed animal. There are different games to play, each with its own way of winning. To win the toy at the basketball game, you have to shoot the ball through the hoop. To win it at the ring toss, you have to toss rings over top of them. The mechanism by which these games work is analogous to how enzymes work: they catalyze specific chemical reactions in order to achieve a certain outcome (winning the toy).	enzyme mechanism	Explain enzyme mechanism using an analogy
A soccer coach is interested in whether the number of goals his team scores varies depending on which playing formation (4-4-2, 3-5-2, etc.) he uses. To answer this question, the coach divides his players into three groups according to playing formation and then calculates the average number of goals scored by each group. The coach then compares the averages using an ANOVA test to determine if there is a statistically significant difference between them.ANOVA can be thought of as a way to compare apples and oranges. In other words, it's a way of determining if there is a statistically significant difference between two or more means (in this case, the number of goals scored by different formations).	anova	Explain ANOVA using an analogy
A big company is interested in how well its salespeople are doing. It assigns each salesperson a score based on the total amount of money they sell. The company then wants to know if there is a difference between how men and women do. To find out, it tests whether the average score for men is different from the average score for women.ANOVA is like taking a survey of all the people in two groups (men and women) and figuring out if the average score for one group (men) is different from the other group (women).	anova	Explain ANOVA using an analogy
Imagine you're a farmer with 100 cows. You want to know how much milk each cow produces, so you collect data on how much milk each cow produces over the course of a month. To do this, you take a sample of 10 cows at random from your herd and record how much milk they produce each day.You might expect that all of the cows in your herd would produce about the same amount of milk, but it's possible that some cows are better milking than others. To find out if there is a difference in the amount of milk produced by different cows in your herd, you could perform an ANOVA test.The ANOVA test calculates whether there is a statistically significant difference between the average dailymilk production for the different groups (in this case, the average daily milk production for each individual cow in your sample). If there is no significant difference between the groups, then it can be concluded that all of the cows in your herd produce about the same amount of milk	anova	Explain ANOVA using an analogy
One can think of Analysis of Variance (ANOVA) as a type of accounting. Just as businesses need to account for their expenses and revenues, researchers conducting experiments must account for the variability in their data. ANOVA is one method used to do this. Imagine that you are running a business with 100 employees. You want to know how much each employee costs you on average. To find this out, you would calculate the total cost of all your employees and then divide it by 100. This would give you the average cost per employee. Now imagine that you have two different groups of employees: Group A and Group B. You want to know if there is a difference in the average cost between these two groups. To find this out, you would calculate the total cost of both groups and then divide it by 200 (100 for each group). This would give you the average cost per employee for each group separately. If the average cost per employee in Group A is different from the average cost per employee in Group B, then we say that there is a significant difference between these two groups.	anova	Explain ANOVA using an analogy
A person's height is determined by many factors, including genes, nutrition, and exercise. Suppose you want to know how much of a person's height is due to genetics. You could gather a group of people whose heights are all very similar, and measure their genetic makeup. Then you could measure the average height of this group, and compare it to the average height of another group of people who have different genetic makeups. This would be an example of an ANOVA test.	anova	Explain ANOVA using an analogy
A thermostat is like a bouncer at a nightclub. It monitors the temperature and if it gets too hot, the bouncer will tell people to leave by turning on the air conditioning. If it gets too cold, the bouncer will turn on the heaters.	thermostat	Explain thermostat using an analogy
A thermostat is a bit like a bouncer at a nightclub. It’s job is to make sure that the temperature in the club is just right – not too hot, not too cold. If it gets too warm, the bouncer will open the door to let some of the heat out. And if it gets too cold, he’ll close the door to keep the warmth in.	thermostat	Explain thermostat using an analogy
A thermostat is like a robot that lives in your house and controls the temperature. You can tell it what temperature you want your house to be, and it will do its best to make sure that the temperature stays at that level.	thermostat	Explain thermostat using an analogy
A thermostat is like a cruise control for your house. It sets the temperature that you want and then it keeps the temperature consistent by turning the furnace on and off as needed.	thermostat	Explain thermostat using an analogy
Thermostats are like tiny, personal chefs that cook food to a perfect temperature and then keep it there until you're ready to eat. They work by constantly monitoring the oven's or stove's temperature and turning it up or down as needed to maintain the set cooking temperature.	thermostat	Explain thermostat using an analogy
Chemical equilibrium is like a see-saw. The two people on the see-saw are equal in weight, and they stay in balance because of the connection between them. If one person gets off the see-saw, it tips over because there is an imbalance. In the same way, when chemicals are in equilibrium, they are balanced because of their connection. If one chemical changes (gets off the see-saw), then equilibrium is lost and the reaction moves towards reestablishing equilibrium.	chemical equilibrium	Explain chemical equilibrium using an analogy
Chemical equilibrium can be thought of as a tug-of-war match in which both teams are equally strong. In this analogy, the two sides represent the reactants and products of a chemical reaction. As long as neither side is stronger than the other, the reaction will continue until both teams are exhausted (the reactants are used up and there are no more products). However, if one side becomes stronger (for example, if more reactants are added), then that team will start to win the match and eventually take over completely.	chemical equilibrium	Explain chemical equilibrium using an analogy
Chemical equilibrium is like a see-saw. When one side goes up, the other side goes down. The same thing happens with chemical reactions. When one reaction speeds up, the other reaction slows down.	chemical equilibrium	Explain chemical equilibrium using an analogy
Chemical equilibrium can be thought of as being a bit like people in a crowded room. In the beginning, some people are standing close to each other while others are spaced out. Over time, people will move around until everyone is more or less evenly spaced out. This is what happens with chemical reactions – the molecules will move around until they reach equilibrium, where the rate of the reaction is equal on both sides.	chemical equilibrium	Explain chemical equilibrium using an analogy
Chemical equilibrium is much like a see-saw. If there is an equal amount of people on each side, the see-saw will be balanced. However, if one person gets up on one side, the see-saw will tilt in that direction. In the same way, if there is an imbalance of chemicals in a solution, the equilibrium will shift to try and restore balance.	chemical equilibrium	Explain chemical equilibrium using an analogy
It is like a grocery store. When you go to the grocery store, they have produce that is fresh and has not been sitting on the shelf for days. This is because the grocery store only orders as much produce as they need and it is delivered fresh to the store. The same principle applies with just-in-time manufacturing.	just-in-time	Explain Just-in-Time using an analogy
Just-in-time is a lot like getting a pizza delivered to your door. You place an order, and the pizzeria makes your pizza fresh when it's ordered. They don't make any extra pizzas ahead of time, so you're always getting a fresh pie.	just-in-time	Explain Just-in-Time using an analogy
A just-in-time inventory system is like a grocery store that never runs out of food. The store orders new stock just as it starts to run low, so there's always enough food on the shelves.	just-in-time	Explain Just-in-Time using an analogy
Just-in-time is like a dishwasher. It cleans dishes as they are used, so there is always a clean dish available when it's needed.	just-in-time	Explain Just-in-Time using an analogy
One analogy for Just-in-time is a grocery store. If you only have a few items in your cart, the store will likely have those items on hand. However, if you have a large list of items, the store will likely need to order some of those items from other stores or suppliers. By ordering only what is needed and when it is needed, the store can save money on inventory costs.	just-in-time	Explain Just-in-Time using an analogy
Adaptive Immunity can be thought of as a body's immune system "memory." Just as in computer memory, where information is stored and can be quickly accessed when needed, the adaptive immune system remembers pathogens that it has encountered before. This allows the body to mount a faster and more effective response against these invaders the next time they are encountered.	adaptive immunity	Explain Adaptive Immunity using an analogy
Adaptive immunity can be thought of as a bouncer at a club. The bouncer is constantly watching the door and when someone tries to enter who isn't supposed to, they are stopped. This is analogous to how adaptive immunity recognizes harmful substances and eliminates them from the body before they can cause harm.	adaptive immunity	Explain Adaptive Immunity using an analogy
One way to think of adaptive immunity is as a city’s emergency response system. If there is an emergency, the city can quickly activate its emergency response plan and send help to where it is needed. The same thing happens with our immune system; if we are exposed to a virus or another infection, our body can quickly respond by activating its immune cells.	adaptive immunity	Explain Adaptive Immunity using an analogy
Adaptive immunity can be likened to a well-trained army. The body's immune system is constantly on the lookout for potentially harmful invaders, such as viruses and bacteria. When an invader is detected, the immune system mobilizes its forces to attack and destroy the intruder. As part of this process, the immune system produces antibodies (special proteins) that specifically target the invading organism. If an individual is exposed to the same invader again, their immune system will remember it and quickly mobilize its defenses to clear out the infection.	adaptive immunity	Explain Adaptive Immunity using an analogy
Adaptive immunity can be thought of as a security guard for your body. The security guard is always on patrol, looking for anything that could harm you. If the security guard sees something dangerous, he will take action to protect you. Adaptive immunity is like the security guard because it constantly patrols your body, looking for any signs of danger. If it detects a threat, it will take action to protect you.	adaptive immunity	Explain Adaptive Immunity using an analogy
Ohm's law is like a traffic light. It tells you when to stop (red) and when to go (green).	ohm's law	Explain Ohm's law using an analogy
Ohm's law is similar to how a garden hose works. If you have the faucet on all the way, the water pressure will be high and the hose will be able to shoot water far away. If you turn the faucet down so that there is less water pressure, then the hose won't be able to shoot water as far. Ohm's law can be explained in a similar way - if there is more voltage (water pressure) available, then more current (amount of water being shot out of the hose) will flow through the circuit.	ohm's law	Explain Ohm's law using an analogy
An analogy for Ohm's law is a water hose. The more water pressure there is in the hose, the faster the water will flow out of the end. Voltage is like water pressure and current is like the amount of water that flows through the hose.	ohm's law	Explain Ohm's law using an analogy
Imagine a water tank with a hose running out of the bottom. If you turn on the faucet, water will start flowing out of the hose. The faster you turn up the faucet, the more water comes out.Now imagine that there is a restriction in the hose, like a kink in it. If you turn up the faucet all the way, no matter how hard you try, not as much water will come out of the hose as if there was no kink in it.The amount of water that comes out of the hose is analogous to electric current (flow of electrons). The pressure from turning up the faucet is analogous to voltage (electric potential energy). And finally, whether or not there's a kink in the hose is analogous to resistance (how easily electricity can flow through something).	ohm's law	Explain Ohm's law using an analogy
Ohm's law can be thought of as a relationship between the water pressure in a hose and the flow rate of water through the hose. The higher the water pressure, the faster the water will flow through the hose. Ohm's law is similar in that it establishes a relationship between voltage, current and resistance. The higher the voltage, the more current will flow through a resistor.	ohm's law	Explain Ohm's law using an analogy
Transcription is the process of taking written text and converting it into a spoken format. This analogy might help to understand it: transcription is like turning subtitles on or off. If you have ever watched a movie in a language that you don't understand, you may have turned on the subtitles to read what everyone is saying. This is similar to transcription - we are taking written words and translating them into an audio format so that people can listen to them.	transcription	Explain Transcription using an analogy
Transcription is like taking a picture of someone. You use a camera to capture an image of the person and then you have a photograph that you can look at later. Transcription is similar because it captures the genetic information from DNA and creates a copy called RNA.	transcription	Explain Transcription using an analogy
Transcription is like a secretary taking notes while someone is speaking. The transcriptionist writes down everything the speaker says, including all the little details.	transcription	Explain Transcription using an analogy
Transcription is like taking dictation. You are given a set of instructions and you write them down as they are spoken.	transcription	Explain Transcription using an analogy
Transcription is a bit like taking dictation. The person giving the dictation (the transcriptionist) will speak into a microphone, and their words will be recorded by the recorder. The transcriptionist will then type up what has been said, exactly as it was spoken.	transcription	Explain Transcription using an analogy
RNA polymerase is like a construction worker. It builds the RNA molecule by linking together pieces of DNA.	rna polymerase	Explain RNA polymerase using an analogy
RNA polymerase is a bit like an assembly line of workers in a factory. The RNA polymerase is the boss, telling the workers what to do and when to do it. The workers are called enzymes, and they each have a specific job to do in creating the RNA molecule.	rna polymerase	Explain RNA polymerase using an analogy
RNA polymerase is similar to a baker. Just as a baker needs flour, yeast, and sugar to make bread, RNA polymerase needs nucleotides to make RNA. The baker puts the ingredients into a dough and kneads it until the dough is smooth. Similarly, RNA polymerase links together the nucleotides to form a strand of RNA.	rna polymerase	Explain RNA polymerase using an analogy
RNA polymerase is a bit like a construction worker. It starts with building blocks (the letters A, T, C, and G) and builds a new strand of RNA by stringing them together one at a time.	rna polymerase	Explain RNA polymerase using an analogy
RNA polymerase can be thought of as a “factory” that manufactures new RNA molecules. It works by reading DNA sequences and copying them into new RNA strands. This process is very similar to how factories produce new products by reading blueprints and copying the designs onto parts or products.	rna polymerase	Explain RNA polymerase using an analogy
Ribosomes are like the factories in a city. They take the instructions (the DNA) and create new products (proteins).	ribosome	Explain Ribosome using an analogy
A ribosome is like a train station. The mRNA (or train) comes in and the ribosomes (the workers at the station) read the instructions on the mRNA to build the protein.	ribosome	Explain Ribosome using an analogy
Ribosomes are like the builders of a city. They take the instructions from the mayor (the DNA) and use them to build the city streets, houses, and businesses.	ribosome	Explain Ribosome using an analogy
Ribosomes are like beehives. They are small, and they swarm around making honey.	ribosome	Explain Ribosome using an analogy
A ribosome can be thought of as a translator between two people who do not share a language. The ribosome takes the instructions for making a protein (contained in the genetic code) and converts them into a sequence of amino acids that can be read by the cell.	ribosome	Explain Ribosome using an analogy
One analogy for activator protein is that it is like a key to a lock. The activator protein binds to the promoter region of the gene and helps to "unlock" it, so that transcription can begin.	activator protein	Explain Activator protein using an analogy
An activator protein is like a key that unlocks a door. The activator protein binds to the promoter region of a gene and then activates (or increases) transcription of that gene.	activator protein	Explain Activator protein using an analogy
An activator protein is to a car's engine as the gas pedal is to the car. The activator protein provides the instructions for starting the cell's engine (i.e. beginning transcription and translation). Just like you need to step on the gas pedal to make the car go, you need to provide an activator protein in order to get transcription and translation going in a cell.	activator protein	Explain Activator protein using an analogy
One analogy for the activator protein is that it is like a key. The activator protein can bind to the promoter region of a gene and "unlock" it, so that transcription can take place.	activator protein	Explain Activator protein using an analogy
An activator protein is like a key that unlocks the door to DNA. It helps to start the process of gene expression, which is necessary for the cell to carry out its functions.	activator protein	Explain Activator protein using an analogy
An electric circuit can be thought of as a garden hose. If you turn on the faucet (the power) and put your thumb over the end of the hose (the resistor), water will come out. If you remove your thumb, the water will flow faster. The more resistance there is in the hose, the slower the water flows.	electric circuit	Explain electric circuit using an analogy
Water analogyElectricity is like water flowing through a pipe. The strength of the flow (electric current) is determined by how big the pipe is and how much water pressure is behind it. The voltage is like the water pressure, and the resistance is like the size of the pipe.	electric circuit	Explain electric circuit using an analogy
Electricity is like water. Just as a river flows through a valley, electricity flows through wires. The voltage is the pressure of the electric current and the resistance is like a dam that slows down the current.	electric circuit	Explain electric circuit using an analogy
Electricity flows like water in a river. Just as rivers have banks to hold the water in place, electric circuits have wires to keep the electricity flowing in one direction. Electrical components are like rocks and plants in a river; they can change the flow of electricity (or water) by obstructing it or altering its path.	electric circuit	Explain electric circuit using an analogy
Electricity is like water in a hose. The voltage (pressure) is the water pressure, and the current (amount of water) is the amount of water flowing through the hose at any given time. Just as with water, you can have different amounts of electricity in different places at the same time.	electric circuit	Explain electric circuit using an analogy
The cell membrane is like a protective barrier for the cells inside the body. It acts as a wall to keep things like bacteria and other harmful substances out. The membrane is also responsible for allowing important things like nutrients and oxygen in. The hydrophobic effect of the cell membrane helps to keep it strong and effective at doing its job.	hydrophobic effect	Explain hydrophobic effect of cell membrane using an analogy.
The cell membrane is like a waterproof coat. The hydrophobic effect is like the water repelling properties of the coat.	hydrophobic effect	Explain hydrophobic effect of cell membrane using an analogy.
One analogy for the hydrophobic effect of cell membrane is that it is like oil droplets in water. The oil droplets do not mix with the water and they stay together.	hydrophobic effect	Explain hydrophobic effect of cell membrane using an analogy.
The cell membrane is like a raincoat. The hydrophobic effect is like the water repelling effect of the raincoat.	hydrophobic effect	Explain hydrophobic effect of cell membrane using an analogy.
The hydrophobic effect of the cell membrane is similar to that of a boat in water. The boat will sit higher in the water because it is less dense than the water. The cell membrane is also less dense than the cytosol and so it sits higher in the cytosol. This is due to the fact that the lipids in the membrane are more hydrophobic than those in the cytosol.	hydrophobic effect	Explain hydrophobic effect of cell membrane using an analogy.
A telephone is a good analogy for biological signal transduction. Sound waves travel through the air on telephone lines and are converted into electrical signals that can be understood by a person on the other end of the line. In a similar way, biochemical signals in cells transmit information by traveling through membranes and being converted into electrical or chemical signals that can be understood by proteins inside the cell.	biological signal transduction	Explain biological signal transduction using an analogy
Biological signal transduction can be thought of as a series of locks and keys. The "lock" is the receptor on the cell surface, and the "key" is the signaling molecule. When the key binds to the lock, it causes a change in shape that opens the door to the inside of the cell. This allows information to flow into or out of the cell, which regulates its activity.	biological signal transduction	Explain biological signal transduction using an analogy
Biological signal transduction can be thought of as a series of locks and keys. The key is the protein that binds to the DNA sequence it recognizes, and the lock is the receptor on the cell surface that accepts that key. When the key fits perfectly into the lock, it opens and allows something else (usually a small molecule) inside. That small molecule then does its job in the cell, which could be anything from turning on or off a gene to starting or stopping a chemical reaction.	biological signal transduction	Explain biological signal transduction using an analogy
If you think of a phone line as a biological signal, the transduction process would be like the conversion of sound into electrical signals that can be understood by a phone. This is done through the use of a microphone and other devices in the phone system. In biology, many different molecules are used to convert signals from one form to another. These molecules are called receptors and they can be found on the surface of cells or inside them.	biological signal transduction	Explain biological signal transduction using an analogy
The process of converting a signal from one form to another is similar to that of a translator who listens to people speaking in one language and converts their words into another language for others to understand. In the same way, a biological signal transducer listens to signals in the body (such as hormones or nerve impulses) and converts them into messages that the cells can understand.	biological signal transduction	Explain biological signal transduction using an analogy
